esau	עשו
jabal	יבל
pauleta	פאולטה
björk	ביורק
solamish	סולמיש
cassander	קסנדרוס
syagrius	סיאגריוס
caracalla	קרקלה
boudica	בודיקיאה
onkelos	אונקלוס
robinho	רוביניו
cuauhtémoc	קואוטמוק
kubrat	קובראט
jugurtha	יוגורתה
raí	ראיי
maniche	מאניש
bucephalus	בוקפאלוס
ovida	אובידה
britannicus	בריטניקוס
muki	מוקי
pertinax	פרטינקס
rammal	רמאל
yiruma	יירומה
brixton	בריקסטון
theophrastus	תאופרסטוס
googoosh	גוגוש
tiësto	טייסטו
yoshitoshi	יושיטושי
zenebework	זנאבווורק
carneades	קרנאדס
ashanti	אשנטי
menander	מנאנדרוס
hatuey	אטואי
archilochus	ארכילוכוס
cleon	קליאון
élson	אלסון
tintoretto	טינטורטו
cratylus	קראטילוס
frumentius	פרומנטיוס
siamun	סיאמון
polycrates	פוליקרטס
ludacris	לודאקריס
eumenes	אאומנס
guntram	גונתרם
akhenaten	אחנתון
ingund	אינגונד
telipinu	תלפינוש
zuleika	זוליכה
vangelis	ואנגליס
domitian	דומיטיאנוס
nasra	נאסרה
molière	מולייר
cædmon	קאדמון
arpachshad	ארפכשד
elpida	אלפידה
ricimer	ריקימר
philomena	פילומנה
polybius	פוליביוס
vercingetorix	ורקינגטוריקס
olympias	אולימפיאס
kālidāsa	קאלידאסה
delkash	דלקאש
bacchylides	באקכילידס
stromae	סטרומאה
appian	אפיאנוס
akon	אייקון
shaka	שאקה
plotinus	פלוטינוס
parmenides	פרמנידס
ronaldinho	רונאלדיניו
bebeto	בבטו
anaximander	אנכסימנדרוס
euhemerus	אוהמרוס
malaria	מלריה
manetho	מנתון
donatello	דונטלו
kesha	קשה
rekha	רקהה
menaechmus	מנכמוס
ricardinho	ריקארדיניו
rurik	רוריק
empedocles	אמפדוקלס
epica	אפיקה
tribonian	טריבוניאן
quirinius	קוויריניוס
adherbal	אדהרבעל
sophocles	סופוקלס
nabonidus	נבונאיד
tolui	טולוי
critolaus	קריטולאוס
reu	רעו
columba	קולומבה
epictetus	אפיקטטוס
livia	ליוויה
polycarp	פוליקרפוס
kalomira	קאלומירה
karandash	קרנדאש
gorgias	גורגיאס
xzibit	אקזיביט
peisistratos	פייסיסטראטוס
interpol	אינטרפול
dida	דידה
guti	גוטי
pithana	פיתחנש
esarhaddon	אסרחדון
hippias	היפיאס
dymphna	דימפנה
ferdowsi	פירדוסי
pheidippides	פידיפידס
balthild	בלדכילדיס
vespasian	אספסיאנוס
riphath	ריפת
herodotus	הרודוטוס
slash	סלאש
rakim	ראקים
vitruvius	ויטרוביוס
orlan	אורלאן
datis	דאטיס
uzziah	עוזיהו
timbaland	טימבלנד
fala	פאלא
hipparchus	היפרכוס
aistulf	אייסטולף
aryabhata	אריאבהטה
lucero	לוסרו
herostratus	הרוסטראטוס
rihanna	ריהאנה
procopius	פרוקופיוס
aspasia	אספאסיה
ahaz	אחז
philolaus	פילולאוס
aeschylus	אייסכילוס
mencius	מנציוס
tostão	טוסטאו
pericles	פריקלס
stilpo	סטילפון
meresamun	מרסאמון
anaxagoras	אנכסגורס
bardiya	ברדיה
hiroshige	הירושיגה
hanging	תלייה
incitatus	אינקיטאטוס
demosthenes	דמוסתנס
elano	אלאנו
rava	רבא
marcian	מרקיאנוס
ulla	עולא
solon	סולון
subliminal	סאבלימינל
shakira	שאקירה
commodus	קומודוס
heraclitus	הרקליטוס
aisha	עאישה
nadar	נדאר
twiggy	טוויגי
necro	נקרו
confucius	קונפוציוס
boethius	בואתיוס
sirusho	סירושו
litovoi	ליטובוי
aybak	אייבכ
afroman	אפרומן
caesarion	קיסריון
vasubandhu	וסובנדהו
ludger	לודגר
nerva	נרווה
raekwon	רייקון
decius	דקיוס
mentewab	מאנטאוואב
lucretius	לוקרטיוס
gangulphus	גנגולפוס
washoe	וואשו
pindar	פינדארוס
formiga	פורמיגה
terah	תרח
philistus	פיליסטוס
eber	עבר
lemar	למר
khafra	חאפרו
mazdak	מזדק
qutuz	קוטוז
cazwell	קאזוול
sabagadis	סבגדיס
caligula	קליגולה
morrissey	מוריסי
idir	אידיר
curnonsky	קורננסקי
wojtek	וויטק
horemheb	חרמחב
careca	קארקה
kutiman	קותימן
vavá	ואוה
kaká	קאקה
guinga	גינגה
edmílson	אדמילסון
zito	זיטו
migueli	מיגלי
pocahontas	פוקהונטס
chamillionaire	קמיליונר
diophantus	דיופנטוס
costinha	קושטיניה
brassaï	בראסאי
lysias	ליסיאס
ashurbanipal	אשורבניפל
bikhakhanim	ביחחנים
neymar	ניימאר
tequila	טקילה
parmenion	פרמניון
radegund	רדגונדיס
sennacherib	סנחריב
xenocles	קסנוקלס
september	ספטמבר
agag	אגג
columbanus	קולומבנוס
brennius	ברניוס
cassiodorus	קסיודורוס
coccinelle	קוקסינל
glaphyra	גלפירה
herblock	הרבלוק
xanthippe	קסנתיפה
boiorix	בוירכאוס
polyperchon	פוליפרכון
stelarc	סטלארק
ammuna	אמונש
basshunter	בסהאנטר
sejanus	סיאנוס
moby	מובי
livilla	ליווילה
croesus	קרויסוס
actaeon	אקטיון
gratian	גרטיאנוס
gummarus	גומרוס
macrinus	מקרינוס
elagabalus	אלאגבאלוס
pachomius	פכומיוס
nilmar	נילמר
skin	סקין
themistocles	תמיסטוקלס
eusébio	אוסביו
thales	תאלס
pitigrilli	פיטיגרילי
somerled	סומרלד
eratosthenes	ארטוסתנס
lidwina	לידווינה
critias	קריטיאס
ataulf	אטהאולף
quintilian	קוינטיליאנוס
brahmagupta	בראהמגופטה
proof	פרוף
nefertiti	נפרטיטי
abdülaziz	אבדילאזיז
wallia	ואליה
artaphernes	ארטפרנס
zico	זיקו
donncoirce	דונכוירכה
ertuğrul	ארטואורול
tirigan	טיריגן
odetta	אודטה
welliton	וליטון
eupolis	אאופוליס
stendhal	סטנדל
suetonius	סווטוניוס
aenesidemus	אנסידמוס
alcman	אלקמן
burebista	בורביסטה
oenomaus	אוינומאוס
joselito	חוזליטו
subutai	סובוטאי
hammurabi	חמורבי
alulim	אלולים
porphyry	פורפיריוס
alboin	אלבוין
capleton	קייפלטון
ctesias	קטסיאס
mardonius	מרדוניוס
petronius	פטרוניוס
fernandel	פרננדל
ahab	אחאב
dunga	דונגה
masinissa	מסיניסה
hydatius	הידטיוס
ovid	אובידיוס
ardaric	ארדאריק
totila	טוטילה
crixus	קריקסוס
archimedes	ארכימדס
tertullian	טרטוליאנוס
alcuin	אלקואין
tarkan	טרקאן
nearchus	נארכוס
pérotin	פרוטין
numerian	נומריאנוס
leucippus	לוקיפוס
marullus	מארולוס
odoacer	אודואקר
skrillex	סקרילקס
ausonius	אוסוניוס
plato	אפלטון
anacreon	אנאקראון
crantor	קראנטור
kiko	קיקו
gilgamesh	גילגמש
hatshepsut	חתשפסות
mausolus	מאוזולוס
paracelsus	פאראצלסוס
jónsi	יונסי
zeuxis	זאוקסיס
diplo	דיפלו
banksy	בנקסי
cleanthes	קלאנתס
cuitláhuac	קואיטלאואק
clitomachus	קליטומאכוס
euripides	אוריפידס
zenobia	זנוביה
novalis	נובאליס
barquq	ברקוק
gundoald	גונדובלד
rivaldo	ריבאלדו
aristippus	אריסטיפוס
roxana	רוקסנה
malo	מכוטוס
clodoaldo	קלודואלדו
periander	פריאנדרוס
galerius	גלריוס
zoroaster	זרתוסטרה
nabopolassar	נבופלאסר
xenophanes	קסנופנס
astrix	אסטריקס
genseric	גאיזריק
fergie	פרגי
titian	טיציאן
nani	נאני
otho	אותו
akihito	אקיהיטו
phasael	פצאל
taharqa	תהרקה
callimachus	קאלימאכוס
posidonius	פוסידוניוס
laika	לייקה
notburga	נוטבורגה
quintillus	קווינטילוס
sappho	סאפפו
agabus	אגבוס
merneptah	מרנפתח
sirhan	סירחאן
plutarch	פלוטארכוס
grafite	גראפיטה
salvian	סלביאנוס
serug	שרוג
glykeria	גליקריה
anahí	אנהי
vitellius	ויטליוס
xenophon	קסנופון
gallienus	גליאנוס
maxentius	מקסנטיוס
democritus	דמוקריטוס
pytheas	פיתאס
nabonassar	נבונצר
dedê	דדה
yehoash	יהואש
belisarius	בליזריוס
adunis	אדוניס
padmasambhava	פדמאסמבהאבה
zizinho	זיזיניו
carinus	קארינוס
cafu	קאפו
pamba	פמבש
cacau	קאקאו
mamai	ממאי
maximian	מקסימיאנוס
protagoras	פרוטגורס
alalngar	אלאנגאר
fredegund	פרדגונד
epaminondas	אפמינונדס
dresta	דרסטה
kahina	קהינה
dalida	דלידה
warrior	ווריור
juvenal	יובנליס
hamuchtar	המוכתר
miyavi	מייאבי
berossus	ברוסוס
oenopides	אוינופידיס
senesino	סנסינו
sarbel	סארבל
rembrandt	רמברנדט
phocas	פוקאס
icarus	איקרוס
hephaestion	הפסטיון
diocletian	דיוקלטיאנוס
irenaeus	אירנאוס
anitta	אניתש
clotilde	קלותילדה
ashoka	אשוקה
zuhayr	זוהייר
antisthenes	אנטיסתנס
erridupizir	ארידופיזיר
hesiod	הסיודוס
bărbat	ברבאט
hubertus	הוברטוס
sizzla	סיזלה
sylvinho	סילביניו
epicurus	אפיקורוס
arcesilaus	ארקסילאוס
keiko	קייקו
lampião	למפיאו
suharto	סוהארטו
asmahan	אסמהאן
romário	רומאריו
seryoga	סיריוגה
everaldo	אבראלדו
euphronios	אופרוניוס
eminem	אמינם
cicinho	סיסיניו
montesquieu	מונטסקייה
glycerius	גליקריוס
ciara	סיארה
ziryab	זיריאב
maturinus	מטורינוס
skanderbeg	סקנדרבג
nostradamus	נוסטרדמוס
harthacnut	הארדיקאנוט
censorinus	סנסורינוס
leodegar	לאודגר
hirohito	הירוהיטו
arrian	אריאנוס
coolio	קוליו
pulcheria	פולכריה
sophonisba	סופוניסבה
theudas	תוידאס
carus	קארוס
alcimus	אלקימוס
buckethead	באקטהד
bourvil	בורביל
florianus	פלוריאנוס
nargis	נרגיס
methuselah	מתושלח
describe	דיסקרייב
unkei	אונקיי
deco	דקו
athaliah	עתליה
nennius	נניוס
pitbull	פיטבול
ishtar	אישתאר
krum	קרום
fairuz	פיירוז
olybrius	אוליבריוס
farinelli	פארינלי
theocritus	תיאוקריטוס
sabicas	סאביקאס
theudebald	תיאודבלד
valerian	ולריאנוס
caupolicán	קאופוליקאן
jushur	נגושור
belinus	בלינוס
chlodomer	כלודומר
nangishlishma	ננגישלישמה
sibawayh	סיבויה
daklon	דקלון
tokhtamysh	טוכטמיש
spartacus	ספרטקוס
hypatia	היפאטיה
kerlon	קרלון
arminius	ארמיניוס
amyrtaeus	אמירתאיוס
taboo	טאבו
habakkuk	חבקוק
alcibiades	אלקיביאדס
galba	גלבה
sigeric	זיגריק
atahualpa	אטאהואלפה
matisyahu	מתיסיהו
draco	דרקון
babur	באבור
apion	אפיון
babatha	בבתא
origen	אוריגנס
zózimo	זוזימו
thucydides	תוקידידס
jovian	יוביאנוס
bill	ביל
daniel	דניאל
steve	סטיב
boris	בוריס
max	מקס
bob	בוב
marcel	מרסל
ian	איאן
von	פון
william	ויליאם
bruce	ברוס
tom	טום
andy	אנדי
taylor	טיילור
andrew	אנדרו
anton	אנטון
chris	כריס
williams	ויליאמס
alessandro	אלסנדרו
herodias	הרודיאס
mike	מייק
oliver	אוליבר
norman	נורמן
scott	סקוט
gordon	גורדון
ron	רון
ken	קן
yossi	יוסי
claude	קלוד
ariel	אריאל
alfred	אלפרד
larry	לארי
franco	פרנקו
smith	סמית
thomas	תומאס
benny	בני
sharon	שרון
frank	פרנק
anthony	אנתוני
ross	רוס
carlos	קרלוס
amos	עמוס
bobby	בובי
cooper	קופר
kate	קייט
doron	דורון
amnon	אמנון
dave	דייב
arnold	ארנולד
warren	וורן
peretz	פרץ
alex	אלכס
harold	הרולד
nelson	נלסון
wilhelm	וילהלם
goldberg	גולדברג
cohen	כהן
golan	גולן
jan	יאן
christopher	כריסטופר
grant	גרנט
carter	קרטר
yair	יאיר
nir	ניר
bruno	ברונו
igor	איגור
gary	גארי
tim	טים
wilson	וילסון
amanda	אמנדה
rob	רוב
avigdor	אביגדור
uzi	עוזי
fred	פרד
harel	הראל
linda	לינדה
dov	דב
ford	פורד
elias	אליאס
keith	קית
robinson	רובינסון
ion	יון
alberto	אלברטו
irving	אירווינג
robert	רוברט
ben	בן
barbara	ברברה
will	ויל
patrick	פטריק
gad	גד
tal	טל
fritz	פריץ
mustafa	מוסטפא
naomi	נעמי
thompson	תומפסון
ed	אד
christian	כריסטיאן
wright	רייט
wallace	וולאס
lionel	ליונל
johannes	יוהנס
de	דה
adam	אדם
roberto	רוברטו
gershon	גרשון
barry	בארי
emma	אמה
davis	דייוויס
ray	ריי
douglas	דאגלס
julius	יוליוס
valens	ואלנס
yoram	יורם
hilarion	הילריון
aristophanes	אריסטופאנס
zelda	זלדה
drusilla	דרוסילה
hippocrates	היפוקרטס
roy	רוי
tacitus	טקיטוס
arthur	ארתור
tyler	טיילר
hugo	הוגו
kim	קים
billy	בילי
hillel	הלל
blake	בלייק
otto	אוטו
stanley	סטנלי
sullivan	סאליבן
randy	רנדי
azzam	עזאם
alexander	אלכסנדר
edith	אדית
alexandru	אלכסנדרו
brad	בראד
kenny	קני
hill	היל
yael	יעל
tamar	תמר
emily	אמילי
dick	דיק
oren	אורן
west	וסט
rubinstein	רובינשטיין
fernando	פרננדו
matt	מאט
abaye	אביי
virgil	ורגיליוס
claudian	קלאודיאנוס
aderet	אדרת
jeconiah	יהויכין
sting	סטינג
tamir	תמיר
hippo	היפון
strabo	סטראבון
esther	אסתר
nas	נאס
aemilianus	איימליאנוס
heinz	היינץ
adi	עדי
art	ארט
rehoboam	רחבעם
divine	דיוויין
nancy	ננסי
colin	קולין
heinrich	היינריך
klein	קליין
diego	דייגו
wayne	ויין
donald	דונלד
margaret	מרגרט
nick	ניק
lee	לי
juan	חואן
harry	הארי
phillips	פיליפס
ted	טד
banks	בנקס
khan	חאן
brooks	ברוקס
nicole	ניקול
gideon	גדעון
avi	אבי
klaus	קלאוס
anderson	אנדרסון
antonio	אנטוניו
hunter	האנטר
dror	דרור
marshall	מרשל
alphonse	אלפונס
elisha	אלישע
yoav	יואב
grace	גרייס
oded	עודד
yaron	ירון
weiss	וייס
dan	דן
walker	ווקר
bar	בר
christina	כריסטינה
maimon	מימון
betty	בטי
phil	פיל
nahum	נחום
helena	הלנה
berger	ברגר
vladimir	ולדימיר
meir	מאיר
baruch	ברוך
campbell	קמפבל
filippo	פיליפו
lars	לארס
terry	טרי
richter	ריכטר
greenberg	גרינברג
cox	קוקס
brandon	ברנדון
uriel	אוריאל
abel	אבל
diana	דיאנה
kennedy	קנדי
gaius	גאיוס
katz	כץ
kurt	קורט
hall	הול
coleman	קולמן
bernstein	ברנשטיין
adler	אדלר
neumann	נוימן
lior	ליאור
washington	וושינגטון
stone	סטון
claudio	קלאודיו
howard	הווארד
gardner	גרדנר
gal	גל
goldstein	גולדשטיין
martin	מרטין
friedrich	פרידריך
wes	וס
rick	ריק
ida	אידה
idan	עידן
timothy	טימותי
ofer	עופר
ronald	רונלד
amit	עמית
sergio	סרחיו
darren	דארן
gilad	גלעד
gheorghe	גאורגה
landau	לנדאו
harris	האריס
eliyahu	אליהו
baker	בייקר
yuri	יורי
eli	אלי
guillaume	גיום
caroline	קרוליין
eddie	אדי
domenico	דומניקו
leonardo	לאונרדו
eliezer	אליעזר
don	דון
cameron	קמרון
rudolf	רודולף
kevin	קווין
luca	לוקה
rose	רוז
ram	רם
yona	יונה
drake	דרייק
shirley	שירלי
shalev	שלו
milton	מילטון
arnon	ארנון
rita	ריטה
julio	חוליו
enrico	אנריקו
siegfried	זיגפריד
seymour	סימור
abba	אבא
turner	טרנר
pierre	פייר
aldo	אלדו
santiago	סנטיאגו
schneider	שניידר
blair	בלייר
clifford	קליפורד
vera	ורה
elimelech	אלימלך
tommy	טומי
strauss	שטראוס
marion	מריון
ferguson	פרגוסון
clara	קלרה
berman	ברמן
ran	רן
roberts	רוברטס
ilan	אילן
white	וייט
russell	ראסל
garrett	גארט
netanyahu	נתניהו
gibson	גיבסון
dudu	דודו
kaplan	קפלן
gerd	גרד
bernhard	ברנהרד
mika	מיקה
fletcher	פלטשר
keren	קרן
itzik	איציק
perkins	פרקינס
alec	אלק
herzog	הרצוג
dora	דורה
ramos	ראמוס
samantha	סמנתה
eran	ערן
valentin	ולנטין
karen	קארן
banai	בנאי
christine	כריסטין
friedman	פרידמן
gilbert	גילברט
manuel	מנואל
henry	הנרי
rené	רנה
mitchell	מיטשל
erich	אריך
avner	אבנר
edwards	אדוארדס
crawford	קרופורד
lawrence	לורנס
del	דל
wolfgang	וולפגנג
harvey	הארווי
helen	הלן
epstein	אפשטיין
armstrong	ארמסטרונג
donovan	דונובן
radu	ראדו
olga	אולגה
franz	פרנץ
anita	אניטה
giora	גיורא
hamilton	המילטון
helmut	הלמוט
marcelo	מרסלו
hayes	הייז
franklin	פרנקלין
shahar	שחר
ryan	ראיין
moshe	משה
pietro	פייטרו
ashkenazi	אשכנזי
hart	הארט
fuller	פולר
herbert	הרברט
lloyd	לויד
mordechai	מרדכי
naim	נעים
lane	ליין
dorothy	דורותי
pascal	פסקל
becker	בקר
biton	ביטון
avital	אביטל
anat	ענת
alejandro	אלחנדרו
lisa	ליסה
nina	נינה
federico	פדריקו
melissa	מליסה
lucy	לוסי
ashley	אשלי
robertson	רוברטסון
long	לונג
mauro	מאורו
craig	קרייג
miranda	מירנדה
zalman	זלמן
lorenzo	לורנצו
bloch	בלוך
morton	מורטון
d	ד
ronen	רונן
lindsay	לינדזי
fanny	פאני
berg	ברג
sanders	סנדרס
barak	ברק
kapoor	קאפור
redman	רדמן
naor	נאור
shavit	שביט
yaniv	יניב
albrecht	אלברכט
raz	רז
ira	איירה
peled	פלד
shannon	שאנון
gunnar	גונאר
donna	דונה
yigal	יגאל
shraga	שרגא
steiner	שטיינר
alfredo	אלפרדו
andersen	אנדרסן
vicente	ויסנטה
ohad	אוהד
erez	ארז
itamar	איתמר
jürgen	יורגן
ziv	זיו
drew	דרו
laura	לורה
fleming	פלמינג
damon	דיימון
patricia	פטרישה
schmitt	שמיט
brenda	ברנדה
josé	חוסה
andré	אנדרה
francisco	פרנסיסקו
ludwig	לודוויג
mikhail	מיכאיל
miguel	מיגל
yevgeny	יבגני
francis	פרנסיס
gabriel	גבריאל
rachel	רחל
maria	מריה
evans	אוונס
simpson	סימפסון
curtis	קרטיס
marco	מרקו
marx	מרקס
murphy	מרפי
uri	אורי
mary	מרי
derek	דרק
lerner	לרנר
tomer	תומר
pini	פיני
yishai	ישי
irina	אירינה
arad	ארד
moritz	מוריץ
ezra	עזרא
austin	אוסטין
ernesto	ארנסטו
eyal	אייל
mario	מריו
adolf	אדולף
gil	גיל
collins	קולינס
alvin	אלווין
cliff	קליף
dwight	דווייט
morgan	מורגן
florence	פלורנס
feldman	פלדמן
lynch	לינץ
griffin	גריפין
neville	נוויל
atkins	אטקינס
bertrand	ברטראן
neil	ניל
yuval	יובל
hardy	הארדי
visconti	ויסקונטי
roman	רומן
kenneth	קנת
ali	עלי
naftali	נפתלי
holly	הולי
jorge	חורחה
géza	גזה
wilkins	וילקינס
cunningham	קנינגהם
lambert	למברט
inbal	ענבל
newman	ניומן
boaz	בועז
titus	טיטוס
fish	פיש
bentley	בנטלי
nissan	ניסן
akiva	עקיבא
finkelstein	פינקלשטיין
desmond	דזמונד
kobi	קובי
valentina	ולנטינה
cole	קול
bernardo	ברנרדו
ward	וורד
floyd	פלויד
rosenberg	רוזנברג
maya	מאיה
berlin	ברלין
edna	עדנה
stan	סטן
eugen	אויגן
ricky	ריקי
magnus	מגנוס
victoria	ויקטוריה
pat	פט
willem	וילם
lou	לו
lev	לב
vincent	וינסנט
moreno	מורנו
italo	איטלו
guillermo	גיירמו
hopkins	הופקינס
shaham	שחם
mariano	מריאנו
menashe	מנשה
boyle	בויל
marina	מרינה
vince	וינס
carmen	כרמן
mira	מירה
shlomi	שלומי
freeman	פרימן
mia	מיה
netzer	נצר
efrat	אפרת
gloria	גלוריה
gustavo	גוסטבו
jonas	יונאס
altman	אלטמן
maud	מוד
tudhaliya	תודחליאש
moss	מוס
dietrich	דיטריך
nilsson	נילסון
gabriela	גבריאלה
popper	פופר
václav	ואצלב
horst	הורסט
zamir	זמיר
ferrer	פרר
audrey	אודרי
eliran	אלירן
koch	קוך
lehmann	להמן
shoshana	שושנה
manfred	מנפרד
egon	אגון
sun	סון
stern	שטרן
nitzan	ניצן
hope	הופ
king	קינג
jörg	ירג
silver	סילבר
liam	ליאם
miloš	מילוש
keller	קלר
imre	אימרה
morrison	מוריסון
avshalom	אבשלום
yoni	יוני
morgenstern	מורגנשטרן
lillian	ליליאן
melanie	מלאני
mintz	מינץ
ulrich	אולריך
reynolds	ריינולדס
shamir	שמיר
debbie	דבי
miri	מירי
benito	בניטו
ilona	אילונה
brown	בראון
ferdinand	פרדיננד
brian	בריאן
edwin	אדווין
horowitz	הורוביץ
barnes	בארנס
kelly	קלי
françois	פרנסואה
higgins	היגינס
menachem	מנחם
lucius	לוקיוס
montgomery	מונטגומרי
zvi	צבי
danny	דני
bradley	בראדלי
joachim	יואכים
schmidt	שמידט
dino	דינו
martha	מרתה
nehemiah	נחמיה
shaw	שו
calvin	קלווין
lang	לאנג
ehud	אהוד
natalia	נטליה
ibrahim	איברהים
eleanor	אלינור
rabin	רבין
hughes	יוז
gottfried	גוטפריד
alon	אלון
halberstam	הלברשטאם
greg	גרג
hahn	האן
newton	ניוטון
aryeh	אריה
foster	פוסטר
page	פייג
robbins	רובינס
wood	ווד
al	אל
lynn	לין
pasha	פאשה
camille	קאמי
alter	אלתר
sela	סלע
young	יאנג
sandy	סנדי
rodrigo	רודריגו
clive	קלייב
annie	אנני
nikita	ניקיטה
axel	אקסל
mann	מאן
henderson	הנדרסון
clinton	קלינטון
randolph	רנדולף
hunt	האנט
ismail	איסמעיל
nadia	נדיה
wang	ואנג
griffith	גריפית
augusto	אוגוסטו
anna	אנה
nash	נאש
albert	אלברט
said	סעיד
schiff	שיף
frances	פרנסס
johann	יוהאן
alexandra	אלכסנדרה
reuven	ראובן
gallagher	גלאגר
bonnie	בוני
goran	גוראן
samir	סמיר
jacopo	יאקופו
carlebach	קרליבך
margalit	מרגלית
kingsley	קינגסלי
nino	נינו
singh	סינג
rice	רייס
orna	אורנה
kirk	קירק
dina	דינה
whitney	ויטני
emerson	אמרסון
petrov	פטרוב
woody	וודי
marley	מארלי
hudson	הדסון
rupert	רופרט
maggie	מגי
mata	מאטה
herzl	הרצל
redgrave	רדגרייב
beck	בק
melvin	מלווין
brady	בריידי
mackenzie	מקנזי
nathan	נתן
norbert	נורברט
grossman	גרוסמן
tyson	טייסון
glover	גלובר
rodney	רודני
armin	ארמין
van	ואן
yehudit	יהודית
moran	מורן
north	נורת
cyrus	סיירוס
malcolm	מלקולם
fernández	פרננדס
micha	מיכה
jános	יאנוש
quintus	קווינטוס
eva	אווה
marie	מארי
o	או
amy	איימי
abu	אבו
kotler	קוטלר
olmert	אולמרט
argov	ארגוב
hitomi	היטומי
gila	גילה
alistair	אליסטר
sylvain	סילביין
kristin	קריסטין
edri	אדרי
meg	מג
colette	קולט
lotte	לוטה
bauer	באואר
didier	דידייה
hagar	הגר
cantor	קנטור
sven	סוון
lasker	לסקר
maor	מאור
hilde	הילדה
azriel	עזריאל
regev	רגב
doris	דוריס
massimo	מאסימו
greta	גרטה
lindo	לינדו
baum	באום
rivlin	ריבלין
clay	קליי
ilana	אילנה
wertheimer	ורטהיימר
clementi	קלמנטי
mel	מל
mahler	מאהלר
spiegel	שפיגל
gadi	גדי
liu	ליו
rodriguez	רודריגז
rosenblum	רוזנבלום
reich	רייך
arazi	ארזי
erasmus	ארסמוס
feinstein	פיינשטיין
marvin	מרווין
marilyn	מרילין
byron	ביירון
goldman	גולדמן
gates	גייטס
inna	אינה
kraft	קראפט
lina	לינה
dalia	דליה
claudia	קלאודיה
landon	לנדון
scholl	שול
holm	הולם
eileen	איילין
armand	ארמנד
reinhold	ריינהולד
hank	האנק
kamehameha	קמחאמחה
wagner	וגנר
avni	אבני
radcliffe	רדקליף
duffy	דאפי
ole	אולה
arafat	ערפאת
amber	אמבר
leroy	לירוי
alf	אלף
orit	אורית
wise	וייז
crosby	קרוסבי
walton	וולטון
martina	מרטינה
gyula	גיולה
dagan	דגן
browning	בראונינג
howe	האו
ackerman	אקרמן
miron	מירון
pasternak	פסטרנק
mazar	מזר
drori	דרורי
bates	בייטס
tito	טיטו
eilat	אילת
salvador	סלבדור
dekel	דקל
vered	ורד
kathleen	קתלין
alicia	אלישה
ioan	יואן
asher	אשר
marino	מארינו
clint	קלינט
graves	גרייבס
teddy	טדי
lenny	לני
harari	הררי
efim	יפים
romano	רומנו
cecilia	ססיליה
paavo	פאבו
goldschmidt	גולדשמידט
kramer	קרמר
molina	מולינה
agricola	אגריקולה
doug	דאג
mac	מק
michal	מיכל
gonzález	גונסאלס
henri	אנרי
nicolae	ניקולאיה
miriam	מרים
burns	ברנס
sophie	סופי
duncan	דאנקן
edmund	אדמונד
cook	קוק
carr	קאר
maximilian	מקסימיליאן
maxwell	מקסוול
mason	מייסון
massacre	טבח
bo	בו
pete	פיט
felix	פליקס
hess	הס
rodríguez	רודריגס
tuvia	טוביה
rosenthal	רוזנטל
madison	מדיסון
abbas	עבאס
yuli	יולי
list	ליסט
sherman	שרמן
steinberg	שטיינברג
mehmed	מהמט
hussein	חוסיין
hawkins	הוקינס
segal	סגל
pinto	פינטו
berry	ברי
edgar	אדגר
tracy	טרייסי
tatyana	טטיאנה
macdonald	מקדונלד
zurab	זוראב
eric	אריק
watson	ווטסון
saint	הקדוש
pedro	פדרו
lucas	לוקאס
sidney	סידני
medina	מדינה
hiller	הילר
lennon	לנון
hanoch	חנוך
miklós	מיקלוש
sally	סאלי
ishmael	ישמעאל
erwin	ארווין
rokeach	רוקח
zahavi	זהבי
hendel	הנדל
brothers	האחים
bell	בל
vittorio	ויטוריו
milan	מילאן
simcha	שמחה
parker	פארקר
sofer	סופר
hugh	יו
hirsch	הירש
vanessa	ונסה
orly	אורלי
goossens	גוסנס
warner	וורנר
hong	הונג
abulafia	אבולעפיה
beatrice	ביאטריס
zoran	זוראן
cynthia	סינתיה
daniels	דניאלס
scarlatti	סקרלטי
temple	טמפל
curie	קירי
rutherford	רתרפורד
pavel	פאבל
herschel	הרשל
rosie	רוזי
shalom	שלום
rufus	רופוס
maxim	מקסים
mizrahi	מזרחי
katie	קייטי
flynn	פלין
berl	ברל
diane	דיאן
calderón	קלדרון
shapira	שפירא
alfonso	אלפונסו
kyle	קייל
park	פארק
augustus	אוגוסטוס
fouad	פואד
wolf	וולף
penn	פן
levin	לוין
dayan	דיין
mozart	מוצרט
moore	מור
pablo	פבלו
tony	טוני
nielsen	נילסן
zakai	זכאי
leighton	לייטון
brendan	ברנדן
watts	ווטס
porter	פורטר
miles	מיילס
morosini	מורוזיני
cage	קייג
post	פוסט
gay	גיי
mihai	מיכאי
brontë	ברונטה
greer	גריר
monica	מוניקה
dylan	דילן
barker	בארקר
isser	איסר
golomb	גולומב
elton	אלטון
buck	באק
nicanor	ניקנור
gregor	גרגור
arturo	ארטורו
tadeusz	תדיאוש
stanton	סטנטון
tate	טייט
axelrod	אקסלרוד
marguerite	מרגריט
nicholson	ניקולסון
isaacs	אייזקס
yvonne	איבון
almog	אלמוג
mick	מיק
goodman	גודמן
martini	מרטיני
pál	פאל
sosa	סוסה
dempsey	דמפסי
dori	דורי
oppenheimer	אופנהיימר
fernand	פרנאן
saban	סבן
swift	סוויפט
eliza	אלייזה
clancy	קלנסי
wallach	וולך
ursula	אורסולה
cleveland	קליבלנד
bowen	בואן
olsen	אולסן
robson	רובסון
casadesus	קאסאדסי
napoleon	נפוליאון
quentin	קוונטין
marlon	מרלון
sims	סימס
randall	רנדל
frost	פרוסט
lieberman	ליברמן
patton	פאטון
schumacher	שומאכר
farouk	פארוק
hasson	חסון
hyde	הייד
love	לאב
meridor	מרידור
pisano	פיזאנו
walters	וולטרס
wexler	וקסלר
mcdonnell	מקדונל
władysław	ולדיסלב
dana	דנה
bergman	ברגמן
l	ל
hassan	חסן
shlomo	שלמה
natalie	נטלי
christie	כריסטי
horace	הוראס
lincoln	לינקולן
percy	פרסי
sandra	סנדרה
tiberius	טיבריוס
ruth	רות
du	דו
august	אוגוסט
nissim	נסים
maurice	מוריס
raymond	ריימונד
yehuda	יהודה
antoine	אנטואן
adir	אדיר
iglesias	איגלסיאס
rock	רוק
emiliano	אמיליאנו
mayne	מיין
bentov	בנטוב
dallas	דאלאס
germán	חרמן
ovadia	עובדיה
gazit	גזית
hadad	חדד
artzi	ארצי
lauder	לאודר
geffen	גפן
vaughan	וון
takeo	טקאו
sheridan	שרידן
ove	אובה
bohr	בוהר
geiger	גייגר
livni	לבני
hilary	הילארי
adriana	אדריאנה
antoniazzi	אנטוניאצי
leif	לייף
coppola	קופולה
reinhard	ריינהרד
bing	בינג
gerhard	גרהרד
dillon	דילון
disaster	אסון
thornton	תורנטון
kristol	קריסטול
yeshaq	יסחק
murdoch	מרדוק
anouk	אנוק
liran	לירן
morley	מורלי
deng	דנג
goren	גורן
chava	חוה
ossip	אוסיפ
cardozo	קרדוסו
göring	גרינג
järvi	ירווי
tina	טינה
kravitz	קרביץ
amenhotep	אמנחותפ
lake	לייק
ido	עידו
melamed	מלמד
clayton	קלייטון
eckhart	אקהרט
finkel	פינקל
buddy	באדי
levan	לבאן
miroslav	מירוסלב
davidovich	דוידוביץ
braxton	ברקסטון
esteban	אסטבן
brandt	ברנדט
rubio	רוביו
gutiérrez	גוטיירס
takahashi	טקהאשי
faliero	פאליירו
kirsten	קירסטן
geva	גבע
shalmaneser	שלמנאסר
doyle	דויל
akira	אקירה
handler	הנדלר
shane	שיין
elvis	אלביס
witold	ויטולד
ohayon	אוחיון
drucker	דרוקר
arison	אריסון
agustín	אגוסטין
lessing	לסינג
emilia	אמיליה
maurizio	מאוריציו
navon	נבון
einstein	איינשטיין
irena	אירנה
whitfield	ויטפילד
armando	ארמנדו
carmon	כרמון
fanning	פנינג
connie	קוני
kerr	קר
kertész	קרטס
benson	בנסון
leitner	לייטנר
arquette	ארקט
theuderic	תאודריק
linus	לינוס
mischa	מישה
tengiz	תנגיז
schmid	שמיד
eldad	אלדד
wim	וים
rico	ריקו
halfon	חלפון
almond	אלמונד
schatz	שץ
bronisław	ברוניסלב
gafni	גפני
malin	מאלין
sagi	שגיא
zeitlin	צייטלין
sivan	סיון
navarro	נבארו
pnina	פנינה
heidi	היידי
ettore	אטורה
nora	נורה
publius	פובליוס
yakir	יקיר
milligan	מיליגן
steinitz	שטייניץ
milstein	מילשטיין
weinstein	וינשטיין
gibbons	גיבונס
daphne	דפנה
niv	ניב
helms	הלמס
fathi	פתחי
yadin	ידין
fox	פוקס
rosalyn	רוזלין
len	לן
hezekiah	חזקיהו
angela	אנגלה
böhm	בהם
dirk	דירק
vilner	וילנר
mcqueen	מקווין
holger	הולגר
sands	סנדס
sapir	ספיר
safra	ספרא
orlando	אורלנדו
broderick	ברודריק
kuznetsov	קוזנצוב
enos	אנוס
manuela	מנואלה
gili	גילי
avidan	אבידן
deutsch	דויטש
ioannis	יואניס
jens	ינס
moon	מון
ronaldo	רונאלדו
tzipi	ציפי
lindenstrauss	לינדנשטראוס
oshri	אושרי
bynum	ביינום
sextus	סקסטוס
selena	סלינה
darwish	דרוויש
mercedes	מרסדס
stack	סטאק
yukio	יוקיו
guinness	גינס
segev	שגב
lajos	לאיוש
efrati	אפרתי
michaeli	מיכאלי
hubbard	האברד
grünfeld	גרינפלד
ora	אורה
elbaz	אלבז
jaime	חיימה
wahlberg	וולברג
emmerich	אמריך
yoshida	יושידה
sterling	סטרלינג
flavius	פלביוס
dirceu	דירסאו
cindy	סינדי
pesach	פסח
noah	נח
matan	מתן
bora	בורה
awad	עווד
licinius	ליקיניוס
nadav	נדב
manor	מנור
lulu	לולו
gelfand	גלפנד
ronit	רונית
kagan	קגן
yazdegerd	יזדגרד
romero	רומרו
sharabi	שרעבי
kushnir	קושניר
ostrovsky	אוסטרובסקי
diarra	דיארה
raviv	רביב
bibi	ביבי
dimitrie	דימיטריה
ramesses	רעמסס
blumenfeld	בלומנפלד
kristen	קריסטן
mo	מו
carla	קרלה
geller	גלר
michaelis	מיכאליס
eaton	איטון
aristides	אריסטידס
reshef	רשף
ferrari	פרארי
feinberg	פיינברג
ivica	איביצה
pythagoras	פיתגורס
dion	דיון
keaton	קיטון
felton	פלטון
spitzer	שפיצר
jari	יארי
fiona	פיונה
pekka	פקה
mazur	מזור
price	פרייס
hilton	הילטון
erin	ארין
gediminas	גדימינאס
falco	פאלקו
matilda	מתילדה
stamitz	שטאמיץ
frumkin	פרומקין
milch	מילך
mursili	מורשיליש
hubert	יוברט
yannick	יאניק
waller	וולר
alona	אלונה
ada	עדה
shuli	שולי
peleg	פלג
willis	ויליס
bentwich	בנטוויץ
halimi	חלימי
gaon	גאון
ilanit	אילנית
constantius	קונסטנטיוס
courtney	קורטני
martel	מרטל
nimrod	נמרוד
madonna	מדונה
frisch	פריש
molly	מולי
lennox	לנוקס
sid	סיד
halperin	הלפרין
sadan	סדן
ortega	אורטגה
marcia	מרשה
ghica	גיקה
árpád	ארפאד
yariv	יריב
sanderling	זנדרלינג
milman	מילמן
yekutiel	יקותיאל
vivien	ויוויאן
chico	שיקו
wesley	וסלי
svetozar	סבטוזר
galit	גלית
gibb	גיב
yao	יאו
selig	זליג
holland	הולנד
brenner	ברנר
burke	בורק
agis	אגיס
platt	פלאט
pinkas	פנקס
masha	מאשה
marciano	מרציאנו
lipson	ליפסון
big	ביג
lewandowski	לבנדובסקי
darius	דריווש
renate	רנטה
trey	טריי
blumenthal	בלומנטל
aaronsohn	אהרנסון
kimberly	קימברלי
rich	ריץ
bernoulli	ברנולי
soto	סוטו
zimmermann	צימרמן
krüger	קריגר
veronica	ורוניקה
tomáš	תומאש
moyal	מויאל
irakli	איראקלי
faye	פיי
freud	פרויד
maureen	מורין
houston	יוסטון
herbie	הרבי
mahalalel	מהללאל
malone	מלון
lazar	לזר
beach	ביץ
mesika	מסיקה
grimm	גרים
underwood	אנדרווד
rollins	רולינס
severus	סוורוס
lichtenstein	ליכטנשטיין
parks	פארקס
tamás	תמאש
hecht	הכט
dušan	דושאן
prosper	פרוספר
iosif	יוסיף
gallus	גאלוס
shields	שילדס
vidal	וידאל
shearer	שירר
almagor	אלמגור
power	פאוור
castro	קסטרו
tristan	טריסטן
kasher	כשר
angelos	אנגלוס
krishna	קרישנה
clyde	קלייד
bornsztain	בורנשטיין
aviad	אביעד
grobman	גרובמן
fu	פו
passy	פאסי
lena	לנה
saadia	סעדיה
vega	וגה
nordenskiöld	נורדנשלד
porat	פורת
nitza	ניצה
glenn	גלן
matthew	מתיו
werner	ורנר
aharon	אהרן
spencer	ספנסר
charlotte	שרלוט
semyon	סמיון
abdullah	עבדאללה
louis	לואי
carlo	קרלו
nachman	נחמן
ibn	אבן
robbie	רובי
sforza	ספורצה
adrian	אדריאן
shimshon	שמשון
sharp	שארפ
miller	מילר
kraus	קראוס
basarab	בסאראב
cecil	ססיל
clarence	קלרנס
santos	סנטוס
torres	טורס
gottlieb	גוטליב
rossi	רוסי
paul	פול
lily	לילי
shelley	שלי
mehdi	מהדי
walid	וליד
bond	בונד
day	דיי
gaston	גסטון
emilio	אמיליו
tzur	צור
warburg	ורבורג
walt	וולט
marius	מריוס
whitman	ויטמן
casimir	קזימיר
afonso	אפונסו
lord	לורד
patterson	פטרסון
dixon	דיקסון
meshulam	משולם
stein	שטיין
enrique	אנריקה
louise	לואיז
claudius	קלאודיוס
nicolas	ניקולא
pereira	פריירה
williamson	ויליאמסון
marcus	מרקוס
avishai	אבישי
dale	דייל
gould	גולד
hal	האל
teitelbaum	טייטלבוים
daniela	דניאלה
fabian	פביאן
ángel	אנחל
suárez	סוארס
dorothea	דורותיאה
contarini	קונטאריני
bacon	בייקון
mccarthy	מקארתי
étienne	אטיין
salman	סלמאן
ridley	רידלי
or	אור
todd	טוד
kalonymus	קלונימוס
bronfman	ברונפמן
myung	מיונג
london	לונדון
ivanov	איבנוב
elizabeth	אליזבת
edward	אדוארד
perry	פרי
nikola	ניקולה
frederick	פרדריק
of	מלך
sarah	שרה
gareth	גארת
justus	יוסטוס
touré	טורה
farrelly	פארלי
aharoni	אהרוני
suleiman	סולימאן
arkady	ארקדי
eldar	אלדר
seth	סת
vanderbilt	ואנדרבילט
cruz	קרוז
herz	הרץ
tibor	טיבור
ramsay	רמזי
shechter	שכטר
ludovico	לודוביקו
hadrian	אדריאנוס
abbott	אבוט
ure	יור
weil	וייל
nurit	נורית
kimhi	קמחי
talal	טלאל
hen	חן
hendrik	הנדריק
atar	עטר
luciano	לוסיאנו
popovich	פופוביץ
laurie	לורי
murad	מוראט
saleh	סאלח
gabai	גבאי
roosevelt	רוזוולט
lange	לנגה
kingston	קינגסטון
koenig	קניג
françoise	פרנסואז
antonescu	אנטונסקו
neta	נטע
wyatt	ויאט
aviv	אביב
sigmund	זיגמונד
elena	אלנה
rand	ראנד
auerbach	אוירבך
per	פר
lazarus	לצרוס
stewart	סטיוארט
claire	קלייר
habib	חביב
michel	מישל
dmitry	דמיטרי
palmer	פאלמר
cornelius	קורנליוס
heller	הלר
suzuki	סוזוקי
wade	וייד
winters	וינטרס
nuri	נורי
dandolo	דאנדולו
brătianu	ברטיאנו
elihu	אליהוא
cromwell	קרומוול
gandhi	גנדי
quincy	קווינסי
duff	דאף
powell	פאוול
fonda	פונדה
bennett	בנט
mercer	מרסר
tucker	טאקר
tueni	תוויני
abercrombie	אברקרומבי
waters	ווטרס
bernardino	ברנרדינו
motti	מוטי
weaver	ויבר
rivera	ריברה
bellini	בליני
piero	פיירו
joaquín	חואקין
wells	ולס
aristobulus	אריסטובולוס
peter	פיטר
rami	רמי
butler	באטלר
aziz	עזיז
eduardo	אדוארדו
israel	ישראל
matthias	מתיאס
rav	רב
ilya	איליה
bey	ביי
antoni	אנטוני
hurvitz	הורביץ
mark	מארק
noam	נועם
halevi	הלוי
mahmoud	מחמוד
catherine	קתרין
carol	קרול
stevens	סטיבנס
susan	סוזן
holmes	הולמס
ralph	ראלף
fraser	פרייזר
nikolaus	ניקולאוס
julian	יוליאן
gustav	גוסטב
nikolai	ניקולאי
h	ה
nicholas	ניקולס
oscar	אוסקר
burton	ברטון
bach	באך
pullman	פולמן
strong	סטרונג
sternberg	שטרנברג
arne	ארנה
rahim	רחים
zbigniew	זביגנייב
alva	אלווה
diamond	דיימונד
schnabel	שנאבל
hideki	הידקי
krause	קראוזה
woods	וודס
gradenigo	גראדניגו
nam	נאם
raskin	רסקין
rush	ראש
vsevolod	וסבולוד
yates	ייטס
saltykov	סלטיקוב
colbert	קולבר
barbarigo	בארבאריגו
gwen	גוון
field	פילד
mead	מיד
angus	אנגוס
leila	ליילה
uli	אולי
gennady	גנאדי
sheldon	שלדון
atticus	אטיקוס
schelling	שלינג
webster	ובסטר
beverly	בוורלי
brownlee	בראונלי
crowe	קרואו
heath	הית
nachshon	נחשון
abramson	אברמסון
gershom	גרשום
kemp	קמפ
karami	כראמי
kanievsky	קנייבסקי
danino	דנינו
hicks	היקס
boateng	בואטנג
snow	סנואו
wolfram	וולפרם
ferdinando	פרדיננדו
lorenz	לורנץ
brittany	בריטני
antonius	אנטוניוס
blunt	בלאנט
flores	פלורס
katznelson	כצנלסון
kellerman	קלרמן
leonor	לאונור
sheen	שין
chaya	חיה
sandro	סנדרו
valdés	ואלדס
augustin	אוגוסטן
prestes	פרסטס
toby	טובי
truman	טרומן
lutz	לוץ
lancaster	לנקסטר
haile	היילה
rodolfo	רודולפו
siegel	סיגל
ashton	אשטון
hutton	האטון
vardi	ורדי
dalton	דלטון
khaled	חאלד
radek	ראדק
akbar	אכבר
iancu	ינקו
asa	אסא
mohsen	מוחסן
lippi	ליפי
muzio	מוציו
family	משפחת
spears	ספירס
primo	פרימו
evelyn	אוולין
islam	אסלאם
edelstein	אדלשטיין
idris	אידריס
jensen	ינסן
buckley	באקלי
alonzo	אלונזו
keegan	קיגן
eisner	אייזנר
boleyn	בוליין
popescu	פופסקו
hannibal	חניבעל
lima	לימה
yochai	יוחאי
pankhurst	פנקהרסט
groves	גרובס
luzzatto	לוצאטו
caspi	כספי
larsen	לארסן
wilder	ויילדר
nestor	נסטור
abramov	אברמוב
toledano	טולידאנו
bartolomeo	ברטולומאו
massey	מאסי
nemanja	נמניה
schmitz	שמיץ
bliss	בליס
coolidge	קולידג
răzvan	רזבאן
melville	מלוויל
huffman	האפמן
mccartney	מקרטני
leonel	לאונל
busby	באזבי
rosenbaum	רוזנבאום
brennan	ברנן
pickett	פיקט
durant	דוראנט
schuster	שוסטר
macmillan	מקמילן
amram	עמרם
alberti	אלברטי
foley	פולי
jacobus	יאקובוס
baibars	ביברס
adnan	עדנאן
hildegard	הילדגרד
schulz	שולץ
kress	קרס
tayeb	טייב
magda	מגדה
hoff	הוף
umberto	אומברטו
saunders	סונדרס
harrington	הרינגטון
ingrid	אינגריד
bloom	בלום
fyodor	פיודור
stevenson	סטיבנסון
monroe	מונרו
hermann	הרמן
kent	קנט
riley	ריילי
ernst	ארנסט
t	טי
twersky	טברסקי
lagarde	לגארד
baby	בייבי
astrid	אסטריד
zoltán	זולטן
harriet	הארייט
rawlinson	רולינסון
pierce	פירס
teresa	תרזה
benno	בנו
masham	מאשם
terence	טרנס
mendelssohn	מנדלסון
hartmann	הרטמן
łukasz	לוקאש
hellmesberger	הלמסברגר
raúl	ראול
oswald	אוסוואלד
elliott	אליוט
paolo	פאולו
sam	סם
christoph	כריסטוף
boutros	בוטרוס
leonard	לאונרד
anatoly	אנטולי
ari	ארי
salomon	סלומון
bush	בוש
jesus	ישו
aki	אקי
shmueli	שמואלי
yeivin	ייבין
ball	בול
greenaway	גרינוויי
jehoshaphat	יהושפט
fabrice	פבריס
ochs	אוקס
ionescu	יונסקו
talit	טלית
bock	בוק
sinatra	סינטרה
mctell	מקטל
asch	אש
gaël	גאל
gottlob	גוטלוב
stacy	סטייסי
cher	שר
koller	קולר
engel	אנגל
brando	ברנדו
pike	פייק
seydou	סיידו
michels	מיכלס
bousquet	בוסקה
mikko	מיקו
sachs	זאקס
svetlana	סבטלנה
harish	חריש
maciej	מאציי
lobo	לובו
seal	סיל
hitoshi	היטושי
nara	נארה
lucille	לוסיל
hod	הוד
venizelos	וניזלוס
ikue	איקואה
timoshenko	טימושנקו
somekh	סומך
paris	פריס
toledo	טולדו
izetbegović	איזטבגוביץ
ypsilantis	איפסילנטי
sacher	זאכר
keisuke	קייסוקה
herta	הרטה
forbes	פורבס
shimura	שימורה
svante	סוונטה
temkin	טמקין
panagiotis	פנאיוטיס
haas	האס
vance	ואנס
mossinson	מוסינזון
short	שורט
stanford	סטנפורד
trujillo	טרוחיו
gobat	גובאט
alizée	אליזה
bresson	ברסון
burckhardt	בורקהרדט
breyer	ברייר
miyamoto	מיאמוטו
jovanović	יובאנוביץ
aristide	אריסטיד
lobel	לובל
sadeh	שדה
hašek	האשק
damrosch	דאמרוש
gomes	גומש
primož	פרימוז
donskoy	דונסקוי
shlonsky	שלונסקי
moawad	מעווד
nadal	נדאל
gasol	גאסול
betancourt	בטנקור
wittgenstein	ויטגנשטיין
heine	היינה
lydia	לידיה
walworth	וולוורת
strashun	שטראשון
vic	ויק
dawson	דוסון
cambyses	כנבוזי
mori	מורי
jaroslav	ירוסלב
charpentier	שרפנטייה
english	אינגליש
danker	דנקר
ohana	אוחנה
sargsyan	סרקזיאן
polgar	פולגאר
monaghan	מונאהן
inge	אינגה
gersz	גרז
tikva	תקווה
bianca	ביאנקה
lupu	לופו
glushko	גלושקו
viorel	ויורל
issachar	יששכר
schindler	שינדלר
till	טיל
hillary	הילרי
pelosi	פלוסי
pelé	פלה
pearl	פרל
tigran	טיגראן
nâdiya	נאדיה
fried	פריד
granados	גרנדוס
hansen	הנסן
adel	עאדל
springer	שפרינגר
ōhira	אוהירה
summer	סאמר
modan	מודן
kavadh	קבאד
phoenix	פיניקס
sidi	סידי
clovis	כלוביס
kornel	קורנל
edvard	אדוורד
beckham	בקהאם
atzmon	עצמון
yehezkel	יחזקאל
jansons	יאנסונס
dr	דוקטור
weinberger	ויינברגר
abramsky	אברמסקי
martial	מארטיאליס
gross	גרוס
bono	בונו
lovelace	לאבלייס
raziel	רזיאל
lamdan	למדן
galil	גליל
nati	נתי
moller	מולר
berenice	ברניקי
zaki	זכי
maximiliano	מקסימיליאנו
naveh	נוה
bialik	ביאליק
moody	מודי
simmel	זימל
serena	סרנה
stella	סטלה
cassidy	קסידי
suppiluliuma	שופילוליומש
shklovsky	שקלובסקי
oliphant	אוליפנט
hopper	הופר
colfer	קולפר
miliband	מיליבנד
foucault	פוקו
kenyon	קניון
otte	אוטה
vasile	וסילה
fergus	פרגוס
toller	טולר
dudley	דאדלי
bryce	ברייס
tsankov	צאנקוב
yoshitomo	יושיטומו
steinman	שטיינמן
valdis	ואלדיס
yoko	יוקו
kit	קיט
lasse	לאסה
mijatović	מיאטוביץ
zahara	זהרה
oldham	אולדהם
menezes	מנזס
kalai	קלעי
koussevitzky	קוסביצקי
amin	אמין
combs	קומבס
barzilai	ברזילי
aloni	אלוני
hazony	חזוני
simonov	סימונוב
crystal	קריסטל
janez	יאנז
compton	קומפטון
patinkin	פטינקין
morten	מורטן
ofarim	עופרים
goebbels	גבלס
flinders	פלינדרס
pastore	פסטורה
zevulun	זבולון
dileita	דליטה
bergner	ברגנר
matsys	מסייס
harazi	חרזי
naguib	נגיב
fürst	פירסט
badri	בדרי
musil	מוסיל
diaz	דיאז
roux	רו
hantili	חנתיליש
myrdal	מירדאל
kara	קרא
winfield	וינפילד
hardaway	הארדוויי
tullio	טוליו
liron	לירון
reicha	רייכה
kreutzer	קרויצר
diamant	דיאמנט
lahoud	לחוד
hestrin	הסטרין
kostas	קוסטאס
lombardo	לומברדו
dern	דרן
fares	פארס
nikoloz	ניקולוז
lux	לוקס
feder	פדר
bridge	ברידג
paxton	פקסטון
reeve	ריב
ivry	עברי
zisman	זיסמן
metzger	מצגר
córdoba	קורדובה
carnegie	קרנגי
patty	פטי
tskitishvili	צכיטישווילי
na	נה
fawzi	פאוזי
johner	יונר
bartov	ברטוב
ankri	אנקרי
dubois	דובואה
grigore	גריגורה
cardoso	קרדוזו
milošević	מילושביץ
rona	רונה
namir	נמיר
bébé	בבה
dogg	דוג
lilienthal	ליליינטל
margherita	מרגריטה
elvira	אלווירה
ethel	אתל
iuliu	יוליו
danin	דנין
marat	מאראט
lautaro	לאוטארו
ulrike	אולריקה
wiesel	ויזל
schwartz	שוורץ
mcmahon	מקמהון
ignazio	איניאציו
udo	אודו
brack	בראק
adad	אדד
norton	נורטון
chomsky	חומסקי
carles	קרלס
candice	קנדיס
kahlon	כחלון
penelope	פנלופה
camilo	קמילו
cody	קודי
almeida	אלמיידה
sidon	סידון
anson	אנסון
holman	הולמן
rainey	רייני
chait	חייט
davidi	דוידי
lowry	לאורי
haddad	חדאד
orgad	אורגד
orlev	אורלב
jascha	יאשה
sokolow	סוקולוב
amsalem	אמסלם
ruhama	רוחמה
sparks	ספרקס
lance	לאנס
ettlinger	אטלינגר
abebe	אבבה
conan	קונאן
messina	מסינה
tiepolo	טייפולו
senusret	סנוסרת
razel	רזאל
antonis	אנטוניס
nishri	נשרי
dido	דיידו
pops	פופס
poliakov	פוליאקוב
salam	סלאם
berezutski	ברזוצקי
algirdas	אלגירדאס
sarit	שרית
tauber	טאובר
bertie	ברטי
károly	קארוי
antiochus	אנטיוכוס
saki	סאקי
varda	ורדה
álvarez	אלברס
tin	טין
susanne	סוזנה
botha	בותה
aviram	אבירם
vin	וין
uzan	אוזן
feigl	פייגל
albright	אולברייט
torsten	טורסטן
yahalom	יהלום
vasnetsov	וסנצוב
kolarov	קולארוב
slater	סלייטר
bader	בדר
elsa	אלזה
aliza	עליזה
amina	אמינה
christa	כריסטה
malul	מלול
pollio	פוליו
amichai	עמיחי
tobias	טוביאס
turkow	טורקוב
barzani	ברזאני
kollek	קולק
balboa	בלבואה
norma	נורמה
mosseri	מוסרי
freier	פריאר
fredriksson	פרדריקסון
modigliani	מודיליאני
esti	אסתי
dor	דור
thorne	תורן
fabrizio	פבריציו
graun	גראון
domb	דומב
grafton	גרפטון
brumer	ברומר
har	הר
weinreich	ויינרייך
kalmar	קלמר
monique	מוניק
tarif	טריף
moseley	מוזלי
baazov	באזוב
katarina	קטרינה
aristotle	אריסטו
stanko	סטאנקו
duani	דואני
ice	אייס
amitai	אמיתי
thea	תיאה
avigad	אביגד
pim	פים
sheamus	שיימוס
patch	פאץ
enya	אניה
yogi	יוגי
wilkie	וילקי
bhutto	בהוטו
piper	פייפר
mauricio	מאוריסיו
montenegro	מונטנגרו
babel	באבל
matalon	מטלון
moshik	מושיק
brodsky	ברודסקי
blessing	בלסינג
slavko	סלאבקו
grunfeld	גרונפלד
junge	יונגה
mikoyan	מיקויאן
ascalon	אשקלון
arbel	ארבל
minnie	מיני
mats	מאטס
harlan	הרלן
zweig	צווייג
søren	סרן
nizar	ניזאר
oppenheim	אופנהיים
adib	אדיב
rumyantsev	רומיאנצב
tzidon	צידון
hogan	הוגאן
kvaternik	קווטרניק
prinz	פרינץ
bessie	בסי
ousmane	עוסמאן
huey	יואי
emmett	אמט
calhoun	קלהון
schweitzer	שווייצר
xuxa	שושה
toshio	טושיו
dahl	דאל
thelma	תלמה
lia	ליה
bravo	בראבו
toaff	טואף
reagan	רייגן
roald	רואלד
nicklas	ניקלאס
kubbel	קובל
rudd	ראד
ofek	אופק
noy	נוי
spyridon	ספירידון
bisiach	ביזיאק
viggo	ויגו
yotam	יותם
hristov	חריסטוב
shapur	שבור
weitz	ויץ
erika	אריקה
cardinal	הקרדינל
pasteur	פסטר
firth	פירת
messier	מסיה
slatkin	סלטקין
alma	אלמה
burrell	בורל
johansson	יוהנסון
tova	טובה
petri	פטרי
beckett	בקט
dragan	דראגן
nan	נאן
keitel	קייטל
karsh	קארש
avichai	אביחי
anka	אנקה
timmons	טימונס
székely	סקלי
marisa	מריסה
flatow	פלאטו
blaine	בליין
goldin	גולדין
liebknecht	ליבקנכט
fabius	פאביוס
sperber	שפרבר
damari	דמארי
amdursky	אמדורסקי
paulsen	פאולסן
florent	פלורן
samuil	סמואיל
childebert	כילדבר
golescu	גולסקו
magdalena	מגדלנה
kolbe	קולבה
grenier	גרנייה
balbo	באלבו
scholes	שולס
marinus	מרינוס
hastings	הייסטינגס
wiener	וינר
llewellyn	לואלין
presley	פרסלי
livingston	ליווינגסטון
temin	טמין
aurelian	אורליאנוס
rocha	רושה
preston	פרסטון
malinovsky	מלינובסקי
shostakovich	שוסטקוביץ
maron	מרון
israëls	ישראלס
schwimmer	שווימר
porush	פרוש
matthews	מתיוס
milito	מיליטו
mussolini	מוסוליני
sutcliffe	סאטקליף
lea	לאה
appleby	אפלבי
lapidot	לפידות
mack	מאק
martino	מרטינו
grigorescu	גריגורסקו
rugila	רוגה
artem	ארטיום
trachtenberg	טרכטנברג
paulina	פאולינה
mathieu	מתייה
lazard	לאזארד
biermann	בירמן
boa	בואה
portman	פורטמן
loewe	לווה
asma	אסמא
danziger	דנציגר
most	מוסט
rockwell	רוקוול
sahle	סהלה
leonie	ליאוני
gadot	גדות
kazan	קאזאן
repin	רפין
vadim	ודים
aliyev	אלייב
garay	גאראי
ezequiel	אסקיאל
kerimov	קרימוב
cristiano	כריסטיאנו
dussek	דוסק
ladislav	לדיסלב
missy	מיסי
memmi	ממי
dolores	דולורס
costa	קוסטה
moshonov	מושונוב
trapp	טראפ
ashraf	אשרף
arieli	אריאלי
gordian	גורדיאנוס
gluck	גלוק
abutbul	אבוטבול
grayson	גרייסון
hoffmann	הופמן
riskin	ריסקין
stapleton	סטייפלטון
sabatini	סבטיני
markov	מרקוב
eshkol	אשכול
ronson	רונסון
konwitschny	קונוויטשני
antonia	אנטוניה
friedländer	פרידלנדר
necho	נכו
avihu	אביהו
spiro	ספירו
fukuda	פוקודה
tsirelson	צירלסון
ville	וילה
mckinley	מקינלי
azmi	עזמי
hargitay	הרגיטאי
gat	גת
menuhin	מנוחין
bibiana	ביביאנה
sebastiano	סבסטיאנו
abram	אברם
sima	סימה
walpole	וולפול
yeboah	יבואה
graziani	גרציאני
dustin	דסטין
laskov	לסקוב
goldreich	גולדרייך
memphis	ממפיס
levitzki	לויצקי
starr	סטאר
eman	אימן
lavrinovič	לברינוביץ
cullen	קאלן
amenemhat	אמנמחת
minghella	מינגלה
eshel	אשל
mariana	מריאנה
sutton	סאטון
burstein	בורשטיין
évora	אבורה
kedar	קידר
yasmina	יסמינה
thutmose	תחותמס
lustig	לוסטיג
wilf	וילף
forster	פורסטר
branislav	ברניסלב
macarthur	מקארתור
eitingon	אייטינגון
perlmutter	פרלמוטר
columbus	קולומבוס
ziskind	זיסקינד
megan	מייגן
câmara	קמארה
hedaya	הדאיה
rollo	רולו
barclay	בארקלי
meitner	מייטנר
minsky	מינסקי
foy	פוי
hélder	הלדר
peggy	פגי
leary	לירי
cukierman	צוקרמן
olivero	אוליברו
hakan	הקאן
zachary	זאכרי
milutinović	מילוטינוביץ
honoré	אונורה
paco	פאקו
romeo	רומיאו
avidov	אבידב
zar	זר
goldenberg	גולדנברג
dimitri	דימיטרי
arrigo	אריגו
cedar	סידר
faina	פאינה
shigeru	שיגרו
marceau	מרסו
gallo	גאלו
wasserman	וסרמן
ariana	אריאנה
lorna	לורנה
motzkin	מוצקין
zohar	זוהר
lila	לילה
stoltz	סטולץ
valentinus	ולנטינוס
peña	פנייה
roper	רופר
eskandarian	אסקנדריאן
botta	בוטה
shuki	שוקי
lavrov	לברוב
messing	מסינג
barrios	באריוס
gish	גיש
godunov	גודונוב
grimani	גרימאני
aquino	אקינו
applegate	אפלגייט
barnea	ברנע
schröder	שרדר
toshev	טושב
atiyah	עטיה
micheline	מישלין
borromeo	בורומאו
stanković	סטנקוביץ
ussishkin	אוסישקין
machnes	מכנס
malkin	מלכין
ambrose	אמברוזיוס
azulai	אזולאי
manning	מאנינג
berezovsky	ברזובסקי
livnat	לבנת
morales	מוראלס
gonen	גונן
rafi	רפי
otmar	אוטמר
weltsch	ולטש
sanger	סנגר
scheidemann	שיידמן
revivo	רביבו
heike	הייקה
twain	טוויין
drusus	דרוסוס
korda	קורדה
aulus	אולוס
darío	דריו
luna	לונה
elad	אלעד
sue	סו
shiloah	שילוח
levitan	לויתן
anda	אנדה
nagar	נגר
sandoval	סנדובל
corey	קורי
chiara	קיארה
yocheved	יוכבד
appel	אפל
ipato	איפאטו
esterházy	אסטרהאזי
danilo	דנילו
henning	הנינג
isaias	איסאייס
air	אייר
anspach	אנספך
albin	אלבין
karpin	קרפין
oliveira	אוליביירה
silvio	סילביו
bogdan	בוגדאן
solari	סולארי
serkin	סרקין
shani	שני
hajós	האיוש
darling	דרלינג
derrick	דריק
gerstein	גרשטיין
kirschenbaum	קירשנבאום
biran	בירן
willow	וילו
barnum	ברנום
syrkin	סירקין
bryant	בראיינט
yadlin	ידלין
sadat	סאדאת
weiner	ויינר
sylvius	סילביוס
pines	פינס
dreyfus	דרייפוס
castel	קסטל
keane	קין
barkai	ברקאי
talmon	טלמון
lalo	לאלו
alessandra	אלסנדרה
errico	אריקו
sato	סאטו
collison	קוליסון
piétrus	פיאטרוס
copeland	קופלנד
diesel	דיזל
selinger	זלינגר
azran	עזרן
komorowski	קומורובסקי
nechama	נחמה
marom	מרום
stevie	סטיבי
warwick	ווריק
abbado	אבאדו
thiago	טיאגו
agron	אגרון
bremner	ברמנר
octavian	אוקטביאן
lucien	לוסיאן
roerich	רוריך
chopin	שופן
cantemir	קנטמיר
halford	הלפורד
braga	בראגה
badash	בדש
hellman	הלמן
obama	אובמה
hareven	הראבן
rotem	רותם
sturdza	סטורדזה
frida	פרידה
kenzo	קנזו
machover	מחובר
zygmunt	זיגמונט
antal	אנטל
treybal	טרייבל
brauner	בראונר
fortis	פורטיס
schütz	שיץ
ashur	אשור
mandelbaum	מנדלבאום
liviu	ליביו
turk	טורק
hourani	חוראני
ami	עמי
fields	פילדס
bakri	בכרי
riera	ריירה
sandino	סנדינו
spelling	ספלינג
mercator	מרקטור
gaidar	גאידר
dalal	דלאל
orazio	אורציו
annibale	אניבאלה
gies	חיס
nili	נילי
suvorov	סובורוב
thilo	תילו
devin	דווין
perutz	פרוץ
rubik	רוביק
borowski	בורובסקי
gidron	גדרון
borges	בורחס
marlo	מרלו
kubelík	קובליק
aesop	איזופוס
nico	ניקו
gerrit	חריט
meskhi	מסחי
pellegrini	פלגריני
yisraeli	ישראלי
michalka	מישלקה
shira	שירה
nayla	נאילה
papadopoulos	פאפאדופולוס
baba	בבא
ryder	ריידר
neruda	נרודה
patrice	פטריס
delbert	דלברט
kurzweil	קורצווייל
lins	לינס
yazid	יזיד
timo	טימו
lazarov	לזרוב
sowelu	סוולו
fillmore	פילמור
frankfurter	פרנקפורטר
crane	קריין
tamara	תמרה
rolando	רולנדו
golding	גולדינג
avidar	אבידר
sweid	סוויד
gotye	גוטייה
nebuchadnezzar	נבוכדנצר
anatol	אנטול
tolstoy	טולסטוי
antti	אנטי
sepp	ספ
arlen	ארלן
abe	אבה
riklis	ריקליס
loreen	לורין
bradshaw	ברדשו
babe	בייב
amélie	אמלי
sarandon	סרנדון
decker	דקר
mi	מי
cédric	סדריק
osvaldo	אוסבלדו
loomis	לומיס
avri	אברי
nasrallah	נסראללה
wolman	וולמן
barkat	ברקת
abigail	אביגייל
reinhardt	ריינהרדט
todorov	טודורוב
nenad	ננאד
arias	אריאס
nussbaum	נוסבאום
pleeth	פלית
poincaré	פואנקרה
les	לס
dinur	דינור
delanoë	דלנואה
frankie	פרנקי
orson	אורסון
adderley	אדרלי
paula	פאולה
nana	ננה
rowan	רואן
morozov	מורוזוב
ravitz	רביץ
minkowski	מינקובסקי
russ	ראס
claudel	קלודל
cornwell	קורנוול
mistral	מיסטרל
yasuo	יאסואו
tokugawa	טוקוגאווה
ziegler	ציגלר
lesser	לסר
deschamps	דשאן
wächter	וכטר
colm	קולם
libby	ליבי
rza	ריזה
zahi	זאהי
dorit	דורית
kapodistrias	קפודיסטריאס
yeruham	ירוחם
yedid	ידיד
rinat	רינאט
dürer	דירר
gorky	גורקי
makoto	מקוטו
rasmussen	ראסמוסן
corin	קורין
diogo	דיוגו
demi	דמי
wisdom	ויזדום
allegri	אלגרי
bojan	בויאן
arnuwanda	ארנוואנדש
bruria	ברוריה
negri	נגרי
nadi	נדי
dix	דיקס
selma	סלמה
delbrück	דלבריק
katan	קטן
kenan	קינן
labib	לביב
stanhope	סטנהופ
louisa	לואיזה
thor	תור
mirza	מירזה
breckinridge	ברקינרידג
bullock	בולוק
messas	משאש
gus	גאס
heim	היים
trajan	טריאנוס
sharir	שריר
lenz	לנץ
brahe	ברהה
faris	פאריס
shazar	שזר
aubrey	אוברי
abuhatzeira	אבוחצירא
ziffer	ציפר
conroy	קונרוי
rosario	רוסריו
adele	אדל
áed	אייד
hollander	הולנדר
okada	אוקדה
fleissig	פלייסיג
christensen	כריסטנסן
cannavaro	קנבארו
guerrero	גררו
cimon	קימון
donato	דונאטו
gainsbourg	גינסבורג
hooks	הוקס
lanir	לניר
leshem	לשם
minnelli	מינלי
akiko	אקיקו
gurary	גוראריה
burroughs	בורוז
kip	קיפ
aribert	אריברט
buchbinder	בוכבינדר
mihály	מיהאי
rory	רורי
granot	גרנות
cornelia	קורנליה
barghouti	ברגותי
eden	עדן
salo	סאלו
piron	פירון
hasdai	חסדאי
ayelet	איילת
hirschfeld	הירשפלד
barlow	בארלו
herrera	הררה
neria	נריה
drexler	דרקסלר
sandberg	סנדברג
simhon	שמחון
siniora	סניורה
barrymore	ברימור
nevo	נבו
niels	נילס
weinberg	ויינברג
auster	אוסטר
stricker	שטריקר
bean	בין
shota	שותא
bale	בייל
amir	אמיר
davy	דייווי
purcell	פרסל
laudrup	לאודרופ
réti	רטי
fernanda	פרננדה
caron	קארון
andoni	אנדוני
vázquez	ואסקס
bainbridge	ביינברידג
elyakum	אליקום
himmelfarb	הימלפארב
rosenzweig	רוזנצווייג
tawfiq	תאופיק
molcho	מולכו
nikos	ניקוס
pilar	פילאר
valentino	ולנטינו
haber	הבר
nolan	נולאן
tzabari	צברי
thalía	טליה
dworkin	דבורקין
jacobi	יעקבי
klemperer	קלמפרר
lorraine	לוריין
guglielmo	גוליילמו
melinda	מלינדה
mackinnon	מקינון
dukakis	דוקאקיס
hagai	חגי
skarsgård	סקארסגארד
tori	טורי
sewell	סוול
mckee	מקי
kadyrov	קדירוב
bamberger	במברגר
imelda	אימלדה
ophüls	אופולס
traian	טראיאן
mátyás	מתיאש
schwarzenegger	שוורצנגר
travis	טרוויס
melina	מלינה
noureddine	נוראדין
glick	גליק
beasley	ביזלי
oda	אודה
falah	פלאח
ofra	עפרה
staunton	סטאונטון
kosashvili	קוסאשווילי
zanetti	זאנטי
shahak	שחק
renata	רנאטה
goldhaber	גולדהבר
iddo	עדו
natkho	נאתכו
winter	וינטר
blanc	בלאן
kruger	קרוגר
béart	ביאר
alkalai	אלקלעי
gleeson	גליסון
preminger	פרמינגר
palin	פיילין
yolanda	יולנדה
blanco	בלאנקו
zehava	זהבה
barca	ברקה
shaike	שייקה
pepe	פפה
hakham	חכם
shimon	שמעון
zuccari	צוקרי
shafik	שפיק
broder	ברודר
zvika	צביקה
beardsley	בירדסלי
jakobovits	יעקובוביץ
halpern	הלפרן
guðjohnsen	גודיונסן
kakha	קאחה
hemsworth	המסוורת
mcdaniel	מקדניאל
johanna	יוהנה
cheryl	שריל
swann	סוואן
tismăneanu	טיסמניאנו
daud	דאוד
brailovsky	בריילובסקי
mesut	מסוט
albeck	אלבק
lapid	לפיד
voronin	וורונין
winograd	וינוגרד
wheeler	וילר
hammett	האמט
zussman	זוסמן
godwin	גודווין
ivgy	איבגי
kershaw	קרשו
wendell	ונדל
rosenstein	רוזנשטיין
hecker	הקר
culkin	קולקין
schneersohn	שניאורסון
dovber	דובער
yellin	ילין
casey	קייסי
tahsin	טהסין
karni	קרני
macaulay	מקולי
neurath	נוירת
webb	וב
daryl	דריל
shah	שאה
okamoto	אוקמוטו
yasser	יאסר
maayan	מעין
schreiber	שרייבר
morse	מורס
rojas	רוחאס
rio	ריו
tarō	טרו
dudi	דודי
buber	בובר
prescott	פרסקוט
delitzsch	דליטש
cristoforo	כריסטופורו
yizhar	יזהר
scola	סקולה
lil	ליל
margolin	מרגולין
mcgregor	מקגרגור
orlova	אורלובה
alina	אלינה
bosworth	בוסוורת
pundak	פונדק
jesús	חסוס
kamo	קאמו
patsy	פטסי
yogev	יוגב
irit	אירית
vojislav	ווייסלב
sprinzak	שפרינצק
coelho	קואלו
afek	אפק
pozzo	פוצו
nafa	נפאע
predrag	פרדראג
evron	עברון
osama	אוסאמה
carmel	כרמל
semyonov	סמיונוב
hauser	האוזר
homer	הומרוס
hamdan	חמדאן
tania	טניה
kleiber	קלייבר
escobar	אסקובר
euler	אוילר
rahn	ראן
quaid	קווייד
bender	בנדר
arsen	ארסן
phelps	פלפס
strozzi	סטרוצי
yardena	ירדנה
butch	בוץ
niven	ניבן
kohl	קוהל
ono	אונו
bellman	בלמן
allende	איינדה
chevalier	שבלייה
bly	בליי
kanan	כנעאן
karelitz	קרליץ
wolfson	וולפסון
baram	ברעם
stephanie	שטפני
eames	איימס
lipschitz	ליפשיץ
benayoun	בניון
yoseftal	יוספטל
osbourne	אוסבורן
deschanel	דשנל
bolton	בולטון
grünbaum	גרונבאום
timmy	טימי
kostić	קוסטיץ
tricky	טריקי
elhanan	אלחנן
siegbahn	סיגבאן
séverine	סברין
saud	סעוד
zdeněk	זדנק
hepburn	הפבורן
marić	מאריץ
yatom	יתום
kohlberg	קולברג
farmer	פארמר
bardon	ברדון
marla	מרלה
ratzon	רצון
tamari	תמרי
vasil	וסיל
gonzalo	גונזלו
rapoport	רפופורט
milgrom	מילגרום
weinroth	וינרוט
kendrick	קנדריק
pessoa	פסואה
zilber	זילבר
balih	בליך
taft	טאפט
kristina	קריסטינה
poraz	פורז
frigyes	פרידיש
yanai	ינאי
affleck	אפלק
hiroshi	הירושי
brod	ברוד
fanan	פנאן
furniss	פורניס
memmo	ממו
tribuno	טריבונו
désirée	דזירה
fran	פראן
oistrakh	אויסטרך
kipnis	קיפניס
vitale	ויטאלה
kelis	קליס
malkhaz	מלחז
yarkoni	ירקוני
ariane	אריאן
eero	אירו
sinai	סיני
rossellini	רוסליני
clapton	קלפטון
gabi	גבי
drover	דרובר
rosenfeld	רוזנפלד
mironov	מירונוב
burla	בורלא
shamil	שאמיל
tan	טאן
bayezid	באיזיט
daley	דיילי
hillman	הילמן
valli	ואלי
wirth	וירט
shiri	שירי
goldwasser	גולדווסר
halkin	הלקין
waxman	וקסמן
thomashefsky	טומשבסקי
birgit	בירגיט
shimoni	שמעוני
macy	מייסי
katzir	קציר
benítez	בניטס
dos	דוס
andris	אנדריס
lively	לייבלי
hardin	הרדין
wolfskehl	וולפסקהל
hadar	הדר
agmon	אגמון
atari	עטרי
rudel	רודל
howie	האווי
remez	רמז
paul	פאול
sara	שרה
ernest	ארנסט
toni	טוני
ori	אורי
sam	סאם
amir	עמיר
félix	פליקס
leonard	ליאונרד
stuart	סטיוארט
peter	פטר
mark	מרק
michelle	מישל
gavriel	גבריאל
herman	הרמן
morris	מוריס
schwarz	שוורץ
marcus	מרכוס
eliot	אליוט
albert	אלבר
yisrael	ישראל
paulo	פאולו
dane	דיין
paula	פולה
yang	יאנג
müller	מילר
martín	מרטין
marc	מארק
sholom	שלום
rudolph	רודולף
natan	נתן
fuchs	פוקס
reuben	ראובן
kelley	קלי
pieter	פיטר
braun	בראון
dmitri	דמיטרי
blum	בלום
barton	ברטון
moses	משה
bent	בנט
eddy	אדי
stern	סטרן
marko	מרקו
laurence	לורנס
antony	אנטוני
ryan	ריאן
sydney	סידני
harry	הרי
weinberg	וינברג
abbie	אבי
lukas	לוקאס
nissim	ניסים
noam	נעם
cory	קורי
frédéric	פרדריק
elisabeth	אליזבת
thomas	תומס
bryan	בריאן
ralph	רלף
vladislav	ולדיסלב
tzvi	צבי
parker	פרקר
eduard	אדוארד
ilie	איליה
clare	קלייר
romain	רומן
simha	שמחה
nikolay	ניקולאי
young	יונג
elon	אלון
dawn	דון
al	א
ana	אנה
boruch	ברוך
mor	מור
robert	רובר
gil	חיל
davies	דייוויס
pitt	פיט
billie	בילי
ferenc	פרנץ
solomon	שלמה
shelly	שלי
janusz	יאנוש
éva	אווה
bergmann	ברגמן
nicolae	ניקולאה
dana	דיינה
quinn	קווין
anatoliy	אנטולי
patrik	פטריק
evans	אוואנס
andre	אנדרה
johan	יוהאן
man	מאן
mário	מריו
glen	גלן
franck	פרנק
mordecai	מרדכי
judah	יהודה
matías	מתיאס
horace	הורטיוס
zur	צור
deryck	דריק
suleiman	סלימאן
bel	בל
busch	בוש
daniele	דניאלה
teresa	טרסה
mendelsohn	מנדלסון
haggai	חגי
terrence	טרנס
fabián	פביאן
rin	טין
maksim	מקסים
gregg	גרג
velázquez	דייגו
preis	פרייס
tin	רין
oswald	אוסוולד
micah	מיכה
gold	גולד
douglass	דאגלס
lana	לנה
ihor	איגור
martin	מרטן
emir	אמיר
nathalie	נטלי
péguy	פגי
katy	קייטי
petit	פטי
pears	פירס
marta	מרתה
suzanne	סוזן
tracey	טרייסי
mario	מאריו
rui	רוי
alma	עלמה
edwin	אבוט
abbott	אדווין
claudia	קלודיה
leah	לאה
gerhard	גרהארד
rik	ריק
chen	חן
seth	שת
mizrachi	מזרחי
nils	נילס
murad	מוראד
zoltán	זולטאן
carlo	קארלו
todd	לינקולן
lincoln	טוד
leonhard	לאונרד
harris	הריס
zohar	זהר
henrique	אנריקה
stephens	סטיבנס
reyes	רייס
beno	בנו
evgeny	יבגני
kagan	כגן
bradley	ברדלי
auerbach	אוארבך
ronald	רונאלד
murat	מוראט
domenico	קונטאריני
contarini	דומניקו
hansen	האנסן
anatoly	אנאטולי
gastón	גסטון
nathan	נייתן
vasile	ואסילה
willem	הנדריק
pär	פר
sali	סאלי
livingstone	ליווינגסטון
nurith	נורית
pat	פאט
sheryl	שריל
curt	קורט
mahmoud	עבאס
kenan	קנן
noach	נח
hull	האל
christy	כריסטי
zimmerman	צימרמן
jubal	יובל
harriet	הרייט
schrader	שרדר
moses	מוזס
solomon	סולומון
marek	מארק
paulo	פריירה
bryan	בראיין
petar	פטר
endre	אנדרה
bosch	בוש
