afroman	אפרומן
aybak	אייבכ
litovoi	ליטובוי
sirusho	סירושו
jushur	נגושור
belinus	בלינוס
boethius	בואתיוס
nadar	נדאר
curnonsky	קורננסקי
caligula	קליגולה
kutiman	קותימן
careca	קארקה
pindar	פינדארוס
bourvil	בורביל
idir	אידיר
morrissey	מוריסי
arminius	ארמיניוס
vasubandhu	וסובנדהו
raekwon	רייקון
washoe	וואשו
gangulphus	גנגולפוס
pytheas	פיתאס
belisarius	בליזריוס
nerva	נרווה
brennius	ברניוס
caesarion	קיסריון
plutarch	פלוטארכוס
confucius	קונפוציוס
necro	נקרו
mentewab	מאנטאוואב
notburga	נוטבורגה
posidonius	פוסידוניוס
lucretius	לוקרטיוס
daklon	דקלון
ahab	אחאב
fernandel	פרננדל
karandash	קרנדאש
hydatius	הידטיוס
guti	גוטי
livilla	ליווילה
masinissa	מסיניסה
dunga	דונגה
ovid	אובידיוס
crixus	קריקסוס
dymphna	דימפנה
ardaric	ארדאריק
xzibit	אקזיביט
peisistratos	פייסיסטראטוס
totila	טוטילה
riphath	ריפת
sabicas	סאביקאס
cazwell	קאזוול
ishtar	אישתאר
philistus	פיליסטוס
theudas	תוידאס
wojtek	וויטק
theudebald	תיאודבלד
horemheb	חרמחב
mazdak	מזדק
lemar	למר
spartacus	ספרטקוס
khafra	חאפרו
coolio	קוליו
eber	עבר
terah	תרח
formiga	פורמיגה
glaphyra	גלפירה
twiggy	טוויגי
sabagadis	סבגדיס
ludger	לודגר
decius	דקיוס
alulim	אלולים
hammurabi	חמורבי
fergie	פרגי
qutuz	קוטוז
clitomachus	קליטומאכוס
ammuna	אמונש
radegund	רדגונדיס
xanthippe	קסנתיפה
xenocles	קסנוקלס
cassiodorus	קסיודורוס
herblock	הרבלוק
sennacherib	סנחריב
alboin	אלבוין
gummarus	גומרוס
brahmagupta	בראהמגופטה
xenophanes	קסנופנס
nabopolassar	נבופלאסר
oenomaus	אוינומאוס
epicurus	אפיקורוס
suetonius	סווטוניוס
welliton	וליטון
plato	אפלטון
pérotin	פרוטין
ctesias	קטסיאס
archimedes	ארכימדס
pitigrilli	פיטיגרילי
eusébio	אוסביו
numerian	נומריאנוס
leucippus	לוקיפוס
pocahontas	פוקהונטס
boiorix	בוירכאוס
polyperchon	פוליפרכון
gallienus	גליאנוס
stelarc	סטלארק
zito	זיטו
chamillionaire	קמיליונר
migueli	מיגלי
columbanus	קולומבנוס
agag	אגג
coccinelle	קוקסינל
xenophon	קסנופון
moby	מובי
sejanus	סיאנוס
september	ספטמבר
basshunter	בסהאנטר
edmílson	אדמילסון
brassaï	בראסאי
costinha	קושטיניה
parmenion	פרמניון
ashurbanipal	אשורבניפל
tequila	טקילה
guinga	גינגה
lysias	ליסיאס
diophantus	דיופנטוס
kaká	קאקה
vavá	ואוה
aristippus	אריסטיפוס
rivaldo	ריבאלדו
neymar	ניימאר
bikhakhanim	ביחחנים
bucephalus	בוקפאלוס
pauleta	פאולטה
maniche	מאניש
boudica	בודיקיאה
alcman	אלקמן
björk	ביורק
jabal	יבל
burebista	בורביסטה
kubrat	קובראט
akon	אייקון
odetta	אודטה
raí	ראיי
ovida	אובידה
robinho	רוביניו
cuauhtémoc	קואוטמוק
cassander	קסנדרוס
élson	אלסון
pachomius	פכומיוס
cleon	קליאון
stendhal	סטנדל
yiruma	יירומה
muki	מוקי
rammal	רמאל
elagabalus	אלאגבאלוס
menander	מנאנדרוס
aenesidemus	אנסידמוס
britannicus	בריטניקוס
joselito	חוזליטו
eupolis	אאופוליס
cratylus	קראטילוס
ashanti	אשנטי
archilochus	ארכילוכוס
abdülaziz	אבדילאזיז
polycrates	פוליקרטס
ludacris	לודאקריס
tirigan	טיריגן
ertuğrul	ארטואורול
eumenes	אאומנס
ingund	אינגונד
frumentius	פרומנטיוס
siamun	סיאמון
domitian	דומיטיאנוס
aisha	עאישה
vangelis	ואנגליס
nasra	נאסרה
elpida	אלפידה
arpachshad	ארפכשד
cædmon	קאדמון
donncoirce	דונכוירכה
telipinu	תלפינוש
olympias	אולימפיאס
wallia	ואליה
anaximander	אנכסימנדרוס
euhemerus	אוהמרוס
delkash	דלקאש
appian	אפיאנוס
kālidāsa	קאלידאסה
polybius	פוליביוס
bebeto	בבטו
artaphernes	ארטפרנס
guntram	גונתרם
philomena	פילומנה
malaria	מלריה
manetho	מנתון
parmenides	פרמנידס
skin	סקין
reu	רעו
gilgamesh	גילגמש
hatshepsut	חתשפסות
nabonidus	נבונאיד
polycarp	פוליקרפוס
mausolus	מאוזולוס
paracelsus	פאראצלסוס
livia	ליוויה
nearchus	נארכוס
bardiya	ברדיה
alcuin	אלקואין
tertullian	טרטוליאנוס
sophocles	סופוקלס
skrillex	סקרילקס
tarkan	טרקאן
tolui	טולוי
kiko	קיקו
mardonius	מרדוניוס
empedocles	אמפדוקלס
capleton	קייפלטון
petronius	פטרוניוס
subutai	סובוטאי
porphyry	פורפיריוס
epictetus	אפיקטטוס
adherbal	אדהרבעל
ausonius	אוסוניוס
columba	קולומבה
anacreon	אנאקראון
tribonian	טריבוניאן
crantor	קראנטור
rurik	רוריק
hanging	תלייה
aeschylus	אייסכילוס
ahaz	אחז
themistocles	תמיסטוקלס
critias	קריטיאס
uzziah	עוזיהו
hipparchus	היפרכוס
philolaus	פילולאוס
orlan	אורלאן
macrinus	מקרינוס
googoosh	גוגוש
yoshitoshi	יושיטושי
nilmar	נילמר
gratian	גרטיאנוס
actaeon	אקטיון
croesus	קרויסוס
timbaland	טימבלנד
stilpo	סטילפון
somerled	סומרלד
demosthenes	דמוסתנס
thales	תאלס
odoacer	אודואקר
marullus	מארולוס
tostão	טוסטאו
pericles	פריקלס
solon	סולון
commodus	קומודוס
lidwina	לידווינה
ulla	עולא
ataulf	אטהאולף
eratosthenes	ארטוסתנס
quintilian	קוינטיליאנוס
heraclitus	הרקליטוס
cuitláhuac	קואיטלאואק
genseric	גאיזריק
cleanthes	קלאנתס
euripides	אוריפידס
nani	נאני
galerius	גלריוס
zoroaster	זרתוסטרה
phasael	פצאל
otho	אותו
banksy	בנקסי
adunis	אדוניס
anahí	אנהי
yehoash	יהואש
padmasambhava	פדמאסמבהאבה
glykeria	גליקריה
bărbat	ברבאט
zenobia	זנוביה
maxentius	מקסנטיוס
novalis	נובאליס
montesquieu	מונטסקייה
ziryab	זיריאב
ciara	סיארה
glycerius	גליקריוס
nostradamus	נוסטרדמוס
seryoga	סיריוגה
romário	רומאריו
skanderbeg	סקנדרבג
maturinus	מטורינוס
suharto	סוהארטו
sizzla	סיזלה
hubertus	הוברטוס
astrix	אסטריקס
sylvinho	סילביניו
lampião	למפיאו
antisthenes	אנטיסתנס
hesiod	הסיודוס
arcesilaus	ארקסילאוס
ashoka	אשוקה
nabonassar	נבונצר
fairuz	פיירוז
athaliah	עתליה
sophonisba	סופוניסבה
pulcheria	פולכריה
censorinus	סנסורינוס
taboo	טאבו
kerlon	קרלון
alcibiades	אלקיביאדס
chlodomer	כלודומר
carus	קארוס
esarhaddon	אסרחדון
dida	דידה
interpol	אינטרפול
pithana	פיתחנש
jónsi	יונסי
hamuchtar	המוכתר
babur	באבור
origen	אוריגנס
babatha	בבתא
sappho	סאפפו
sirhan	סירחאן
merneptah	מרנפתח
agabus	אגבוס
salvian	סלביאנוס
quintillus	קווינטילוס
dedê	דדה
grafite	גראפיטה
callimachus	קאלימאכוס
tokhtamysh	טוכטמיש
theocritus	תיאוקריטוס
unkei	אונקיי
nangishlishma	ננגישלישמה
hirohito	הירוהיטו
deco	דקו
galba	גלבה
caupolicán	קאופוליקאן
sibawayh	סיבויה
nargis	נרגיס
taharqa	תהרקה
zózimo	זוזימו
laika	לייקה
thucydides	תוקידידס
nennius	נניוס
matisyahu	מתיסיהו
florianus	פלוריאנוס
pitbull	פיטבול
serug	שרוג
zeuxis	זאוקסיס
diplo	דיפלו
titian	טיציאן
malo	מכוטוס
roxana	רוקסנה
democritus	דמוקריטוס
vitellius	ויטליוס
gundoald	גונדובלד
barquq	ברקוק
alcimus	אלקימוס
atahualpa	אטאהואלפה
harthacnut	הארדיקאנוט
buckethead	באקטהד
sigeric	זיגריק
amyrtaeus	אמירתאיוס
hypatia	היפאטיה
jovian	יוביאנוס
habakkuk	חבקוק
arrian	אריאנוס
leodegar	לאודגר
olybrius	אוליבריוס
apion	אפיון
draco	דרקון
valerian	ולריאנוס
farinelli	פארינלי
methuselah	מתושלח
krum	קרום
describe	דיסקרייב
akihito	אקיהיטו
carinus	קארינוס
zizinho	זיזיניו
kahina	קהינה
cafu	קאפו
pamba	פמבש
cacau	קאקאו
icarus	איקרוס
maximian	מקסימיאנוס
mamai	ממאי
dalida	דלידה
cicinho	סיסיניו
eminem	אמינם
asmahan	אסמהאן
everaldo	אבראלדו
euphronios	אופרוניוס
protagoras	פרוטגורס
epaminondas	אפמינונדס
fredegund	פרדגונד
alalngar	אלאנגאר
warrior	ווריור
dresta	דרסטה
sarbel	סארבל
diocletian	דיוקלטיאנוס
erridupizir	ארידופיזיר
clodoaldo	קלודואלדו
periander	פריאנדרוס
clotilde	קלותילדה
zuhayr	זוהייר
oenopides	אוינופידיס
hephaestion	הפסטיון
anitta	אניתש
phocas	פוקאס
rembrandt	רמברנדט
irenaeus	אירנאוס
berossus	ברוסוס
senesino	סנסינו
miyavi	מייאבי
juvenal	יובנליס
herostratus	הרוסטראטוס
critolaus	קריטולאוס
jugurtha	יוגורתה
aspasia	אספאסיה
onkelos	אונקלוס
lucero	לוסרו
epica	אפיקה
esau	עשו
solamish	סולמיש
aryabhata	אריאבהטה
incitatus	אינקיטאטוס
anaxagoras	אנכסגורס
pheidippides	פידיפידס
bacchylides	באקכילידס
kalomira	קאלומירה
stromae	סטרומאה
ferdowsi	פירדוסי
hiroshige	הירושיגה
theophrastus	תאופרסטוס
tiësto	טייסטו
tintoretto	טינטורטו
kesha	קשה
brixton	בריקסטון
menaechmus	מנכמוס
ricardinho	ריקארדיניו
pertinax	פרטינקס
zenebework	זנאבווורק
quirinius	קוויריניוס
syagrius	סיאגריוס
procopius	פרוקופיוס
caracalla	קרקלה
hatuey	אטואי
rekha	רקהה
donatello	דונטלו
carneades	קרנאדס
rihanna	ריהאנה
vercingetorix	ורקינגטוריקס
zico	זיקו
marcian	מרקיאנוס
herodotus	הרודוטוס
nefertiti	נפרטיטי
fala	פאלא
molière	מולייר
shakira	שאקירה
mencius	מנציוס
slash	סלאש
hippias	היפיאס
elano	אלאנו
gorgias	גורגיאס
rava	רבא
proof	פרוף
subliminal	סאבלימינל
keiko	קייקו
vespasian	אספסיאנוס
ricimer	ריקימר
shaka	שאקה
datis	דאטיס
balthild	בלדכילדיס
ronaldinho	רונאלדיניו
akhenaten	אחנתון
plotinus	פלוטינוס
rakim	ראקים
meresamun	מרסאמון
aistulf	אייסטולף
zuleika	זוליכה
vitruvius	ויטרוביוס
bill	ביל
daniel	דניאל
steve	סטיב
boris	בוריס
max	מקס
bob	בוב
marcel	מרסל
ian	איאן
von	פון
william	ויליאם
bruce	ברוס
tom	טום
andy	אנדי
taylor	טיילור
andrew	אנדרו
anton	אנטון
chris	כריס
williams	ויליאמס
alessandro	אלסנדרו
mike	מייק
herodias	הרודיאס
oliver	אוליבר
norman	נורמן
scott	סקוט
gordon	גורדון
ken	קן
ron	רון
yossi	יוסי
claude	קלוד
ariel	אריאל
alfred	אלפרד
larry	לארי
franco	פרנקו
smith	סמית
thomas	תומאס
benny	בני
sharon	שרון
frank	פרנק
anthony	אנתוני
ross	רוס
carlos	קרלוס
amos	עמוס
bobby	בובי
cooper	קופר
kate	קייט
dave	דייב
amnon	אמנון
doron	דורון
arnold	ארנולד
warren	וורן
peretz	פרץ
alex	אלכס
harold	הרולד
nelson	נלסון
wilhelm	וילהלם
goldberg	גולדברג
cohen	כהן
jan	יאן
golan	גולן
christopher	כריסטופר
grant	גרנט
carter	קרטר
yair	יאיר
bruno	ברונו
nir	ניר
igor	איגור
gary	גארי
tim	טים
wilson	וילסון
avigdor	אביגדור
uzi	עוזי
rob	רוב
fred	פרד
amanda	אמנדה
harel	הראל
linda	לינדה
dov	דב
keith	קית
ford	פורד
elias	אליאס
robinson	רובינסון
alberto	אלברטו
ion	יון
irving	אירווינג
robert	רוברט
ben	בן
barbara	ברברה
will	ויל
patrick	פטריק
fritz	פריץ
naomi	נעמי
tal	טל
gad	גד
mustafa	מוסטפא
thompson	תומפסון
ed	אד
christian	כריסטיאן
wallace	וולאס
lionel	ליונל
wright	רייט
johannes	יוהנס
de	דה
adam	אדם
roberto	רוברטו
gershon	גרשון
emma	אמה
barry	בארי
davis	דייוויס
ray	ריי
douglas	דאגלס
julius	יוליוס
drusilla	דרוסילה
roy	רוי
tacitus	טקיטוס
yoram	יורם
aristophanes	אריסטופאנס
hilarion	הילריון
valens	ואלנס
zelda	זלדה
hippocrates	היפוקרטס
arthur	ארתור
hugo	הוגו
tyler	טיילר
kim	קים
billy	בילי
hillel	הלל
blake	בלייק
otto	אוטו
azzam	עזאם
stanley	סטנלי
randy	רנדי
sullivan	סאליבן
alexander	אלכסנדר
kenny	קני
yael	יעל
brad	בראד
hill	היל
edith	אדית
dick	דיק
emily	אמילי
tamar	תמר
alexandru	אלכסנדרו
west	וסט
rubinstein	רובינשטיין
oren	אורן
fernando	פרננדו
matt	מאט
claudian	קלאודיאנוס
divine	דיוויין
virgil	ורגיליוס
hippo	היפון
tamir	תמיר
esther	אסתר
nas	נאס
sting	סטינג
aemilianus	איימליאנוס
abaye	אביי
aderet	אדרת
art	ארט
rehoboam	רחבעם
strabo	סטראבון
adi	עדי
heinz	היינץ
jeconiah	יהויכין
nancy	ננסי
heinrich	היינריך
colin	קולין
klein	קליין
diego	דייגו
wayne	ויין
donald	דונלד
margaret	מרגרט
nick	ניק
lee	לי
juan	חואן
harry	הארי
phillips	פיליפס
banks	בנקס
ted	טד
khan	חאן
brooks	ברוקס
nicole	ניקול
gideon	גדעון
avi	אבי
klaus	קלאוס
anderson	אנדרסון
antonio	אנטוניו
hunter	האנטר
dror	דרור
marshall	מרשל
alphonse	אלפונס
yaron	ירון
elisha	אלישע
yoav	יואב
oded	עודד
weiss	וייס
grace	גרייס
dan	דן
walker	ווקר
bar	בר
christina	כריסטינה
maimon	מימון
betty	בטי
phil	פיל
nahum	נחום
helena	הלנה
berger	ברגר
vladimir	ולדימיר
meir	מאיר
baruch	ברוך
terry	טרי
richter	ריכטר
lars	לארס
campbell	קמפבל
filippo	פיליפו
greenberg	גרינברג
cox	קוקס
uriel	אוריאל
brandon	ברנדון
diana	דיאנה
abel	אבל
kennedy	קנדי
gaius	גאיוס
katz	כץ
hall	הול
kurt	קורט
lior	ליאור
claudio	קלאודיו
neumann	נוימן
bernstein	ברנשטיין
washington	וושינגטון
stone	סטון
coleman	קולמן
adler	אדלר
howard	הווארד
gardner	גרדנר
gal	גל
goldstein	גולדשטיין
martin	מרטין
friedrich	פרידריך
ronald	רונלד
wes	וס
ida	אידה
darren	דארן
idan	עידן
timothy	טימותי
sergio	סרחיו
amit	עמית
gheorghe	גאורגה
rick	ריק
landau	לנדאו
ofer	עופר
gilad	גלעד
harris	האריס
eliyahu	אליהו
baker	בייקר
yuri	יורי
eli	אלי
caroline	קרוליין
guillaume	גיום
leonardo	לאונרדו
eddie	אדי
domenico	דומניקו
eliezer	אליעזר
don	דון
cameron	קמרון
rudolf	רודולף
kevin	קווין
luca	לוקה
rose	רוז
shalev	שלו
yona	יונה
drake	דרייק
ram	רם
shirley	שירלי
siegfried	זיגפריד
seymour	סימור
arnon	ארנון
julio	חוליו
enrico	אנריקו
milton	מילטון
rita	ריטה
turner	טרנר
abba	אבא
pierre	פייר
clara	קלרה
schneider	שניידר
clifford	קליפורד
ferguson	פרגוסון
santiago	סנטיאגו
elimelech	אלימלך
blair	בלייר
strauss	שטראוס
aldo	אלדו
vera	ורה
tommy	טומי
marion	מריון
berman	ברמן
ran	רן
white	וייט
roberts	רוברטס
ilan	אילן
russell	ראסל
bernhard	ברנהרד
perkins	פרקינס
dudu	דודו
garrett	גארט
samantha	סמנתה
eran	ערן
gerd	גרד
christine	כריסטין
valentin	ולנטין
netanyahu	נתניהו
gibson	גיבסון
dora	דורה
itzik	איציק
kaplan	קפלן
karen	קארן
herzog	הרצוג
banai	בנאי
alec	אלק
fletcher	פלטשר
keren	קרן
mika	מיקה
ramos	ראמוס
gilbert	גילברט
friedman	פרידמן
manuel	מנואל
rené	רנה
henry	הנרי
mitchell	מיטשל
erich	אריך
avner	אבנר
edwards	אדוארדס
crawford	קרופורד
lawrence	לורנס
del	דל
wolfgang	וולפגנג
olga	אולגה
donovan	דונובן
harvey	הארווי
helen	הלן
radu	ראדו
epstein	אפשטיין
armstrong	ארמסטרונג
franz	פרנץ
giora	גיורא
anita	אניטה
hamilton	המילטון
helmut	הלמוט
franklin	פרנקלין
marcelo	מרסלו
shahar	שחר
ryan	ראיין
hayes	הייז
moshe	משה
pietro	פייטרו
ashkenazi	אשכנזי
hart	הארט
fuller	פולר
herbert	הרברט
lloyd	לויד
mordechai	מרדכי
miranda	מירנדה
nina	נינה
anat	ענת
robertson	רוברטסון
biton	ביטון
alejandro	אלחנדרו
lisa	ליסה
avital	אביטל
ashley	אשלי
craig	קרייג
melissa	מליסה
lucy	לוסי
lane	ליין
federico	פדריקו
becker	בקר
mauro	מאורו
long	לונג
naim	נעים
pascal	פסקל
dorothy	דורותי
lorenzo	לורנצו
zalman	זלמן
bloch	בלוך
morton	מורטון
d	ד
donna	דונה
peled	פלד
shannon	שאנון
berg	ברג
shraga	שרגא
sanders	סנדרס
yigal	יגאל
raz	רז
andersen	אנדרסן
laura	לורה
erez	ארז
fanny	פאני
kapoor	קאפור
patricia	פטרישה
albrecht	אלברכט
itamar	איתמר
gunnar	גונאר
redman	רדמן
alfredo	אלפרדו
jürgen	יורגן
drew	דרו
schmitt	שמיט
shavit	שביט
fleming	פלמינג
damon	דיימון
vicente	ויסנטה
steiner	שטיינר
ira	איירה
ohad	אוהד
barak	ברק
ziv	זיו
ronen	רונן
brenda	ברנדה
naor	נאור
yaniv	יניב
lindsay	לינדזי
josé	חוסה
andré	אנדרה
francisco	פרנסיסקו
ludwig	לודוויג
mikhail	מיכאיל
yevgeny	יבגני
miguel	מיגל
francis	פרנסיס
gabriel	גבריאל
rachel	רחל
maria	מריה
evans	אוונס
simpson	סימפסון
curtis	קרטיס
marco	מרקו
murphy	מרפי
marx	מרקס
mary	מרי
derek	דרק
uri	אורי
lerner	לרנר
eyal	אייל
ernesto	ארנסטו
arad	ארד
yishai	ישי
pini	פיני
moritz	מוריץ
irina	אירינה
ezra	עזרא
austin	אוסטין
tomer	תומר
mario	מריו
adolf	אדולף
gil	גיל
collins	קולינס
feldman	פלדמן
florence	פלורנס
neville	נוויל
cliff	קליף
bertrand	ברטראן
atkins	אטקינס
morgan	מורגן
lynch	לינץ
alvin	אלווין
griffin	גריפין
dwight	דווייט
neil	ניל
yuval	יובל
hardy	הארדי
roman	רומן
visconti	ויסקונטי
kenneth	קנת
ali	עלי
naftali	נפתלי
wilkins	וילקינס
nissan	ניסן
rosenberg	רוזנברג
newman	ניומן
finkelstein	פינקלשטיין
edna	עדנה
fish	פיש
ward	וורד
lambert	למברט
akiva	עקיבא
maya	מאיה
kobi	קובי
floyd	פלויד
boaz	בועז
géza	גזה
eugen	אויגן
valentina	ולנטינה
inbal	ענבל
titus	טיטוס
jorge	חורחה
holly	הולי
bernardo	ברנרדו
bentley	בנטלי
berlin	ברלין
cole	קול
cunningham	קנינגהם
desmond	דזמונד
stan	סטן
magnus	מגנוס
ricky	ריקי
victoria	ויקטוריה
willem	וילם
pat	פט
lou	לו
lev	לב
vincent	וינסנט
morgenstern	מורגנשטרן
melanie	מלאני
egon	אגון
reynolds	ריינולדס
mariano	מריאנו
zamir	זמיר
maud	מוד
mintz	מינץ
liam	ליאם
horst	הורסט
silver	סילבר
vince	וינס
miri	מירי
debbie	דבי
popper	פופר
audrey	אודרי
nitzan	ניצן
gabriela	גבריאלה
tudhaliya	תודחליאש
keller	קלר
sun	סון
shamir	שמיר
jörg	ירג
mira	מירה
menashe	מנשה
moss	מוס
shlomi	שלומי
hopkins	הופקינס
lillian	ליליאן
gloria	גלוריה
netzer	נצר
miloš	מילוש
ilona	אילונה
carmen	כרמן
yoni	יוני
shaham	שחם
guillermo	גיירמו
avshalom	אבשלום
freeman	פרימן
benito	בניטו
nilsson	נילסון
shoshana	שושנה
king	קינג
moreno	מורנו
manfred	מנפרד
efrat	אפרת
imre	אימרה
altman	אלטמן
jonas	יונאס
eliran	אלירן
stern	שטרן
václav	ואצלב
lehmann	להמן
ulrich	אולריך
morrison	מוריסון
ferrer	פרר
italo	איטלו
dietrich	דיטריך
boyle	בויל
mia	מיה
gustavo	גוסטבו
hope	הופ
koch	קוך
marina	מרינה
brown	בראון
ferdinand	פרדיננד
brian	בריאן
edwin	אדווין
horowitz	הורוביץ
barnes	בארנס
kelly	קלי
françois	פרנסואה
higgins	היגינס
menachem	מנחם
lucius	לוקיוס
montgomery	מונטגומרי
zvi	צבי
danny	דני
bradley	בראדלי
joachim	יואכים
dino	דינו
nehemiah	נחמיה
lang	לאנג
calvin	קלווין
martha	מרתה
shaw	שו
schmidt	שמידט
gottfried	גוטפריד
natalia	נטליה
hughes	יוז
ibrahim	איברהים
ehud	אהוד
eleanor	אלינור
rabin	רבין
alon	אלון
halberstam	הלברשטאם
page	פייג
foster	פוסטר
aryeh	אריה
newton	ניוטון
hahn	האן
robbins	רובינס
greg	גרג
wood	ווד
al	אל
pasha	פאשה
lynn	לין
rodrigo	רודריגו
alter	אלתר
sandy	סנדי
young	יאנג
camille	קאמי
sela	סלע
wang	ואנג
nadia	נדיה
henderson	הנדרסון
axel	אקסל
annie	אנני
ismail	איסמעיל
griffith	גריפית
randolph	רנדולף
hunt	האנט
nikita	ניקיטה
clive	קלייב
augusto	אוגוסטו
mann	מאן
clinton	קלינטון
anna	אנה
nash	נאש
albert	אלברט
said	סעיד
frances	פרנסס
schiff	שיף
johann	יוהאן
reuven	ראובן
alexandra	אלכסנדרה
goran	גוראן
bonnie	בוני
grossman	גרוסמן
whitney	ויטני
kirk	קירק
rice	רייס
marley	מארלי
redgrave	רדגרייב
maggie	מגי
armin	ארמין
samir	סמיר
orna	אורנה
glover	גלובר
rodney	רודני
tyson	טייסון
herzl	הרצל
mata	מאטה
rupert	רופרט
beck	בק
kingsley	קינגסלי
singh	סינג
nathan	נתן
brady	בריידי
emerson	אמרסון
petrov	פטרוב
dina	דינה
gallagher	גלאגר
nino	נינו
norbert	נורברט
melvin	מלווין
carlebach	קרליבך
jacopo	יאקופו
mackenzie	מקנזי
woody	וודי
hudson	הדסון
margalit	מרגלית
van	ואן
north	נורת
cyrus	סיירוס
moran	מורן
yehudit	יהודית
malcolm	מלקולם
micha	מיכה
fernández	פרננדס
eva	אווה
quintus	קווינטוס
jános	יאנוש
marie	מארי
o	או
amy	איימי
abu	אבו
gadi	גדי
cantor	קנטור
avni	אבני
colette	קולט
clay	קליי
lina	לינה
gila	גילה
mel	מל
clementi	קלמנטי
pasternak	פסטרנק
kamehameha	קמחאמחה
dalia	דליה
rivlin	ריבלין
bauer	באואר
ackerman	אקרמן
olmert	אולמרט
reich	רייך
kotler	קוטלר
crosby	קרוסבי
amber	אמבר
walton	וולטון
claudia	קלאודיה
kraft	קראפט
doris	דוריס
efim	יפים
argov	ארגוב
alistair	אליסטר
dagan	דגן
byron	ביירון
tito	טיטו
azriel	עזריאל
marvin	מרווין
marilyn	מרילין
marino	מארינו
alf	אלף
doug	דאג
orit	אורית
bates	בייטס
sylvain	סילביין
ioan	יואן
graves	גרייבס
martina	מרטינה
baum	באום
wertheimer	ורטהיימר
gyula	גיולה
meg	מג
lindo	לינדו
gates	גייטס
feinstein	פיינשטיין
regev	רגב
edri	אדרי
massimo	מאסימו
hilde	הילדה
maor	מאור
agricola	אגריקולה
duffy	דאפי
greta	גרטה
spiegel	שפיגל
drori	דרורי
kathleen	קתלין
rosenblum	רוזנבלום
inna	אינה
rodriguez	רודריגז
asher	אשר
holm	הולם
salvador	סלבדור
ole	אולה
erasmus	ארסמוס
romano	רומנו
arafat	ערפאת
armand	ארמנד
wagner	וגנר
liu	ליו
kramer	קרמר
leroy	לירוי
eileen	איילין
kristin	קריסטין
lasker	לסקר
wise	וייז
mahler	מאהלר
goldschmidt	גולדשמידט
ilana	אילנה
radcliffe	רדקליף
dekel	דקל
vered	ורד
paavo	פאבו
teddy	טדי
hagar	הגר
molina	מולינה
landon	לנדון
clint	קלינט
goldman	גולדמן
sven	סוון
howe	האו
reinhold	ריינהולד
hank	האנק
mazar	מזר
harari	הררי
hitomi	היטומי
didier	דידייה
lotte	לוטה
cecilia	ססיליה
lenny	לני
arazi	ארזי
browning	בראונינג
scholl	שול
miron	מירון
alicia	אלישה
eilat	אילת
mac	מק
michal	מיכל
gonzález	גונסאלס
henri	אנרי
nicolae	ניקולאיה
miriam	מרים
burns	ברנס
sophie	סופי
duncan	דאנקן
cook	קוק
edmund	אדמונד
carr	קאר
maximilian	מקסימיליאן
massacre	טבח
mason	מייסון
maxwell	מקסוול
bo	בו
pete	פיט
felix	פליקס
list	ליסט
hess	הס
yuli	יולי
madison	מדיסון
tuvia	טוביה
rodríguez	רודריגס
abbas	עבאס
rosenthal	רוזנטל
steinberg	שטיינברג
sherman	שרמן
mehmed	מהמט
hussein	חוסיין
hawkins	הוקינס
macdonald	מקדונלד
tatyana	טטיאנה
segal	סגל
tracy	טרייסי
berry	ברי
zurab	זוראב
pinto	פינטו
edgar	אדגר
eric	אריק
watson	ווטסון
saint	הקדוש
pedro	פדרו
sidney	סידני
lucas	לוקאס
ishmael	ישמעאל
medina	מדינה
sally	סאלי
hendel	הנדל
vittorio	ויטוריו
bell	בל
hiller	הילר
brothers	האחים
zahavi	זהבי
erwin	ארווין
hanoch	חנוך
rokeach	רוקח
lennon	לנון
miklós	מיקלוש
simcha	שמחה
milan	מילאן
parker	פארקר
sofer	סופר
hugh	יו
hirsch	הירש
herschel	הרשל
warner	וורנר
scarlatti	סקרלטי
curie	קירי
rosie	רוזי
zoran	זוראן
pavel	פאבל
vanessa	ונסה
beatrice	ביאטריס
daniels	דניאלס
cynthia	סינתיה
hong	הונג
abulafia	אבולעפיה
goossens	גוסנס
orly	אורלי
rutherford	רתרפורד
temple	טמפל
shalom	שלום
rufus	רופוס
maxim	מקסים
mizrahi	מזרחי
katie	קייטי
flynn	פלין
diane	דיאן
berl	ברל
calderón	קלדרון
shapira	שפירא
kyle	קייל
alfonso	אלפונסו
augustus	אוגוסטוס
park	פארק
fouad	פואד
wolf	וולף
penn	פן
levin	לוין
dayan	דיין
mozart	מוצרט
moore	מור
pablo	פבלו
tony	טוני
sosa	סוסה
fernand	פרנאן
frost	פרוסט
marguerite	מרגריט
isser	איסר
walters	וולטרס
leighton	לייטון
saban	סבן
watts	ווטס
post	פוסט
oppenheimer	אופנהיימר
mick	מיק
axelrod	אקסלרוד
barker	בארקר
love	לאב
greer	גריר
nicholson	ניקולסון
brontë	ברונטה
gregor	גרגור
dempsey	דמפסי
tate	טייט
schumacher	שומאכר
dylan	דילן
randall	רנדל
monica	מוניקה
olsen	אולסן
mihai	מיכאי
marlon	מרלון
elton	אלטון
hyde	הייד
stanton	סטנטון
hasson	חסון
cage	קייג
zakai	זכאי
robson	רובסון
pál	פאל
almog	אלמוג
buck	באק
wallach	וולך
meridor	מרידור
brendan	ברנדן
clancy	קלנסי
gay	גיי
eliza	אלייזה
patton	פאטון
ursula	אורסולה
isaacs	אייזקס
farouk	פארוק
napoleon	נפוליאון
nicanor	ניקנור
miles	מיילס
lieberman	ליברמן
martini	מרטיני
tadeusz	תדיאוש
pisano	פיזאנו
yvonne	איבון
goodman	גודמן
dori	דורי
quentin	קוונטין
swift	סוויפט
mcdonnell	מקדונל
wexler	וקסלר
cleveland	קליבלנד
nielsen	נילסן
arturo	ארטורו
porter	פורטר
casadesus	קאסאדסי
bowen	בואן
morosini	מורוזיני
golomb	גולומב
sims	סימס
władysław	ולדיסלב
bergman	ברגמן
dana	דנה
l	ל
hassan	חסן
shlomo	שלמה
horace	הוראס
natalie	נטלי
sandra	סנדרה
christie	כריסטי
lincoln	לינקולן
tiberius	טיבריוס
percy	פרסי
ruth	רות
du	דו
august	אוגוסט
nissim	נסים
maurice	מוריס
raymond	ריימונד
yehuda	יהודה
antoine	אנטואן
pythagoras	פיתגורס
dirceu	דירסאו
clayton	קלייטון
rosalyn	רוזלין
awad	עווד
gibbons	גיבונס
fathi	פתחי
milch	מילך
michaelis	מיכאליס
irena	אירנה
frisch	פריש
bentov	בנטוב
dušan	דושאן
árpád	ארפאד
galit	גלית
yazdegerd	יזדגרד
matilda	מתילדה
zeitlin	צייטלין
kristol	קריסטול
manuela	מנואלה
halperin	הלפרין
pesach	פסח
bing	בינג
herbie	הרבי
yadin	ידין
stack	סטאק
freud	פרויד
matan	מתן
moon	מון
aristides	אריסטידס
gallus	גאלוס
iosif	יוסיף
sapir	ספיר
helms	הלמס
ferrari	פרארי
gili	גילי
einstein	איינשטיין
niv	ניב
lazar	לזר
castro	קסטרו
raviv	רביב
elvis	אלביס
brandt	ברנדט
broderick	ברודריק
tzipi	ציפי
thornton	תורנטון
deng	דנג
malin	מאלין
mesika	מסיקה
vidal	וידאל
molly	מולי
vega	וגה
avidan	אבידן
frumkin	פרומקין
kasher	כשר
milman	מילמן
falco	פאלקו
pinkas	פנקס
krüger	קריגר
masha	מאשה
lulu	לולו
kuznetsov	קוזנצוב
selig	זליג
sterling	סטרלינג
coppola	קופולה
darwish	דרוויש
gediminas	גדימינאס
licinius	ליקיניוס
fiona	פיונה
aviad	אביעד
ramesses	רעמסס
daphne	דפנה
sadan	סדן
lajos	לאיוש
soto	סוטו
melamed	מלמד
gutiérrez	גוטיירס
renate	רנטה
witold	ויטולד
ronit	רונית
lennox	לנוקס
tomáš	תומאש
nimrod	נמרוד
spitzer	שפיצר
agis	אגיס
svetozar	סבטוזר
darius	דריווש
shalmaneser	שלמנאסר
segev	שגב
zimmermann	צימרמן
leif	לייף
ada	עדה
ove	אובה
mazur	מזור
jaime	חיימה
wesley	וסלי
porat	פורת
sivan	סיון
nordenskiöld	נורדנשלד
passy	פאסי
bentwich	בנטוויץ
drucker	דרוקר
mursili	מורשיליש
milligan	מיליגן
waller	וולר
oshri	אושרי
gazit	גזית
chico	שיקו
vivien	ויוויאן
saadia	סעדיה
yukio	יוקיו
yannick	יאניק
navarro	נבארו
kagan	קגן
angelos	אנגלוס
dimitrie	דימיטריה
ossip	אוסיפ
big	ביג
ghica	גיקה
yao	יאו
rollins	רולינס
miroslav	מירוסלב
yoshida	יושידה
flavius	פלביוס
davidovich	דוידוביץ
beach	ביץ
levan	לבאן
marciano	מרציאנו
yeshaq	יסחק
geffen	גפן
arquette	ארקט
fanning	פנינג
lewandowski	לבנדובסקי
gaon	גאון
burke	בורק
lipson	ליפסון
bohr	בוהר
takeo	טקאו
michaeli	מיכאלי
bibi	ביבי
shearer	שירר
kirsten	קירסטן
shuli	שולי
hecht	הכט
hubert	יוברט
krishna	קרישנה
ostrovsky	אוסטרובסקי
whitfield	ויטפילד
benson	בנסון
kristen	קריסטן
sharabi	שרעבי
jari	יארי
handler	הנדלר
agustín	אגוסטין
hilton	הילטון
houston	יוסטון
felton	פלטון
göring	גרינג
buddy	באדי
mo	מו
reinhard	ריינהרד
romero	רומרו
ohayon	אוחיון
yakir	יקיר
tina	טינה
grünfeld	גרינפלד
artzi	ארצי
price	פרייס
cindy	סינדי
rich	ריץ
emilia	אמיליה
grimm	גרים
braxton	ברקסטון
murdoch	מרדוק
lauder	לאודר
mischa	מישה
willis	ויליס
madonna	מדונה
constantius	קונסטנטיוס
keaton	קיטון
kushnir	קושניר
lena	לנה
gibb	גיב
lessing	לסינג
hadad	חדד
peleg	פלג
alona	אלונה
geva	גבע
doyle	דויל
shields	שילדס
sands	סנדס
underwood	אנדרווד
almagor	אלמגור
halimi	חלימי
ronaldo	רונאלדו
tristan	טריסטן
nadav	נדב
wahlberg	וולברג
mahalalel	מהללאל
yekutiel	יקותיאל
courtney	קורטני
gelfand	גלפנד
maureen	מורין
sextus	סקסטוס
bronisław	ברוניסלב
schatz	שץ
stamitz	שטאמיץ
hezekiah	חזקיהו
bynum	ביינום
ovadia	עובדיה
pekka	פקה
irakli	איראקלי
publius	פובליוס
mercedes	מרסדס
heidi	היידי
amenhotep	אמנחותפ
kimberly	קימברלי
weinstein	וינשטיין
adir	אדיר
ortega	אורטגה
safra	ספרא
ido	עידו
malone	מלון
dion	דיון
eldad	אלדד
anouk	אנוק
geller	גלר
martel	מרטל
ivica	איביצה
fu	פו
ioannis	יואניס
sheridan	שרידן
vilner	וילנר
ora	אורה
carla	קרלה
reshef	רשף
prosper	פרוספר
jens	ינס
orlando	אורלנדו
feinberg	פיינברג
geiger	גייגר
järvi	ירווי
akira	אקירה
finkel	פינקל
böhm	בהם
almond	אלמונד
shane	שיין
brenner	ברנר
marcia	מרשה
esteban	אסטבן
hubbard	האברד
lake	לייק
rubio	רוביו
bornsztain	בורנשטיין
clyde	קלייד
kravitz	קרביץ
pnina	פנינה
dirk	דירק
manor	מנור
dallas	דאלאס
faliero	פאליירו
milstein	מילשטיין
carmon	כרמון
ettore	אטורה
eckhart	אקהרט
mayne	מיין
parks	פארקס
holger	הולגר
eaton	איטון
lichtenstein	ליכטנשטיין
leitner	לייטנר
tengiz	תנגיז
maurizio	מאוריציו
armando	ארמנדו
rock	רוק
diarra	דיארה
severus	סוורוס
navon	נבון
blumenfeld	בלומנפלד
elbaz	אלבז
sanderling	זנדרלינג
guinness	גינס
trey	טריי
aaronsohn	אהרנסון
yariv	יריב
moyal	מויאל
livni	לבני
nitza	ניצה
selena	סלינה
erin	ארין
ilanit	אילנית
blumenthal	בלומנטל
tamás	תמאש
cardozo	קרדוסו
bernoulli	ברנולי
sid	סיד
veronica	ורוניקה
gerhard	גרהרד
fox	פוקס
takahashi	טקהאשי
emiliano	אמיליאנו
holland	הולנד
dillon	דילון
arison	אריסון
disaster	אסון
adriana	אדריאנה
goren	גורן
grobman	גרובמן
chava	חוה
faye	פיי
morley	מורלי
antoniazzi	אנטוניאצי
lindenstrauss	לינדנשטראוס
nora	נורה
iglesias	איגלסיאס
liran	לירן
power	פאוור
steinitz	שטייניץ
mcqueen	מקווין
bora	בורה
rico	ריקו
efrati	אפרתי
schmid	שמיד
wim	וים
angela	אנגלה
gafni	גפני
vaughan	וון
noah	נח
platt	פלאט
sagi	שגיא
emmerich	אמריך
len	לן
connie	קוני
enos	אנוס
kertész	קרטס
theuderic	תאודריק
linus	לינוס
kerr	קר
deutsch	דויטש
germán	חרמן
halfon	חלפון
hilary	הילארי
