ildibad	ильдебад
vlastimir	властимир
aspelta	аспелта
osgyth	осита
ulfilas	вульфила
aspazija	аспазия
bulbul	бюльбюль
aybak	айбек
kaliopi	калиопи
nadar	надар
xenophanes	ксенофан
acarius	акарий
nagarjuna	нагарджуна
bulbuljan	бюльбюльджан
yesühei	есугей
xandão	шандан
siaspiqa	сиаспика
abadios	авадий
laborec	лаборец
antalcidas	анталкид
rainilaiarivony	райнилайаривуни
confucius	конфуций
blacatz	блакац
noemi	ноэми
aristocreon	аристокреон
gunthamund	гунтамунд
euspicius	евспикий
bleda	бледа
priscillian	присциллиан
careca	карека
eperatus	эперат
tarcisius	тарцизий
hsinbyushin	синбьюшин
pahiño	паиньо
dwynwen	дуйнвен
maroboduus	маробод
kruto	круто
leotychidas	леотихид
pindar	пиндар
geronimo	джеронимо
sirusho	сирушо
ardagast	ардагаст
suggs	саггс
oreco	ореко
grock	грок
maharbal	магарбал
caravaggio	караваджо
winwaloe	гвеноле
silenoz	силенос
agobard	агобард
rikdag	рикдаг
kirka	кирка
userkare	усеркара
raageshwari	раджешвари
anmary	анмари
menes	менес
athalaric	аталарих
tzitzak	чичак
fernandão	фернандао
athanaric	атанарих
elemund	гелемунд
giambologna	джамболонья
peleg	фалек
vasugupta	васугупта
moby	моби
tiradentes	тирадентис
arubani	арубаини
analmaye	аналмаи
proculus	прокул
hamacarus	хамакар
wassaf	вассаф
pushmataha	пушматаха
columbanus	колумбан
onomacritus	ономакрит
bakenranef	бокхорис
oroles	орол
liuvigild	леовигильд
deioces	дейок
arletty	арлетти
mindarus	миндар
surdas	сурдас
hernanes	эрнанес
cleophon	клеофонт
nabopolassar	набопаласар
aphrahat	афраат
wihomarc	виомарк
momchil	момчил
hazael	азаил
sheba	савей
temüge	тэмуге
dnyaneshwar	джнянешвар
elpinice	эльпиника
cynddylan	кинддилан
vasubandhu	васубандху
adaloald	аделоальд
washoe	уошо
shvarn	шварн
scheherazade	шахерезада
dōkyō	докё
boniak	боняк
theodectes	теодект
britches	бричес
willigis	виллигиз
ardaric	ардарих
speusippus	спевсипп
mardonius	мардоний
trentemøller	трентемёллер
subutai	субэдэй
semaun	семаун
marozia	марозия
lekain	лёкен
cazuza	казуза
atisha	атиша
tiu	тиу
totila	тотила
pentadius	пентадий
sequoyah	секвойя
manorama	манорама
diwanus	дивон
crixus	крикс
basilina	василина
ariamir	ариамир
plectrude	плектруда
bryaxis	бриаксис
scopas	скопас
capleton	каплетон
witteric	виттерих
adwaita	адвайта
ziying	цзыин
quorthon	куортон
wigstan	вигстан
uurad	вурад
feyrouz	фейруз
csézy	чези
öljaitü	олджейту
mausolus	мавсол
hecatomnus	гекатомн
weetamoo	уитаму
anacreon	анакреонт
onesimos	онесим
metacomet	метакомет
cunobeline	кунобелин
clitomachus	клитомах
cimabue	чимабуэ
crantor	крантор
huneric	хунерих
isembart	изембарт
panamarenko	панамаренко
hugobert	гугоберт
eugendus	евгенд
hincmar	гинкмар
chenoa	ченоа
taeyang	тхэян
jorane	жоран
tenskwatawa	тенскватава
parshatatar	паршататар
malchik	сочувствие
eber	евер
doryssus	дорисс
popé	попе
massasoit	массасойт
mantorras	манторраш
nestorius	несторий
barsine	барсина
tesourinha	тезоуринья
amalasuntha	амаласунта
katyayana	катьяяна
bagyidaw	баджидо
horemheb	хоремхеб
callisthenes	каллисфен
bionca	бионка
terah	фарра
hōnen	хонэн
dōgen	догэн
masinissa	массинисса
absalon	абсалон
austromoine	австремоний
gudfred	гудфред
hydatius	идаций
eutropius	евтропий
olympius	олимпий
ahab	ахав
thorismund	торисмунд
jentina	джентина
fernandel	фернандель
bramantino	брамантино
aristagoras	аристагор
teshub	тешуб
khafra	хафра
hogzilla	хогзилла
madhukar	мадукар
mazdak	маздакизм
namatius	намаций
siptah	саптах
koke	коке
tizoc	тисок
fergie	ферги
eurytus	еврит
menkaure	микерин
numerian	нумериан
sudirman	судирман
pérotin	перотин
richbod	рихбод
bahmanyār	бахманяр
kalulu	калулу
leucippus	левкипп
shagrath	шаграт
tribhuvanāditya	трибхуванадитьяварман
sikelgaita	сишельгаита
prajadhipok	прачадипок
lura	лура
gorazd	горазд
pinturicchio	пинтуриккьо
ulpian	ульпиан
capucine	капучине
toqtaqiya	токтакия
aleijadinho	алейжадинью
antinous	антиной
santigold	сантиголд
oenomaus	эномай
welliton	веллитон
birbal	бирбал
daugirutis	довгерд
terpander	терпандр
rintaro	ринтаро
brahmagupta	брахмагупта
ulaghchi	улагчи
fazang	фацзан
josimar	жозимар
nakashidze	накашидзе
enravota	енравота
wovoka	вовока
matfrid	матфрид
alboin	альбоин
hammurabi	хаммурапи
alulim	алулим
eunus	евн
astennu	астенну
rasoherina	расухерина
qutuz	кутуз
shammai	шаммай
bienheuré	бьеноре
gelimer	гелимер
valmiki	вальмики
pacatianus	пакациан
archimedes	архимед
bartatua	партатуа
framta	фрамтан
naropa	наропа
urmuz	урмуз
cunipert	куниперт
cunibert	куниберт
meinwerk	майнверк
ctesias	ктесий
harmoko	хармоко
harpalus	гарпал
audoin	аудоин
thurstan	турстан
ansgar	ансгар
ronaldinho	роналдиньо
plotinus	плотин
djedkhonsuefankh	джедхонсуефанх
dosoftei	дософтей
gervinho	жервиньо
fridianus	фридиан
gesalec	гезалех
bezprym	безприм
demades	демад
akhenaten	эхнатон
shammuramat	шаммурамат
nichiren	нитирэн
garrincha	гарринча
bacchylides	вакхилид
philochorus	филохор
nelinho	нелиньо
sridevi	шридеви
hypereides	гиперид
polygnotos	полигнот
vercingetorix	верцингеториг
börte	бортэ
wermad	веомад
columella	колумелла
teoman	теоман
arouca	ароука
ansegisel	анзегизель
gervadius	герват
tooji	туджи
theognostus	феогност
narimantas	наримунт
nefertiti	нефертити
zuqaqip	зукакип
hornswoggle	хорнсвоггл
zico	зико
quarentinha	куарентинья
grifo	грифон
æthelstan	этельстан
mihirakula	михиракула
ricimer	рицимер
taranatha	таранатха
hermocrates	гермократ
meja	мея
dela	дела
vitiges	витигес
molière	мольер
teia	тейя
zendaya	зендая
kapaakea	капаакеа
menkheperre	менхеперра
lycortas	ликорт
ankhesenamun	анхесенамон
kaumualii	каумуалии
vavá	вава
guntheuc	гунтека
rabbula	раббула
edmílson	эдмилсон
jotapianus	иотапиан
pribina	прибина
khasekhemwy	хасехемуи
lugalanda	лугальанда
dromtön	дромтонпа
charilaus	харилай
urukagina	уруинимгина
hunico	унико
rumiñahui	руминьяви
śūdraka	шудрака
evasius	эвазий
galaton	галатон
siranush	сирануйш
neymar	неймар
einhard	эйнхард
cigoli	чиголи
minggatu	мингату
athanagild	атанагильд
twosret	таусерт
iophon	иофон
nolito	нолито
stigand	стиганд
micipsa	миципса
jorginho	жоржиньо
epicurus	эпикур
aviamotornaya	авиамоторная
rainiharo	райнихару
jucilei	жусилей
zorsines	зорсин
thrasymachus	фрасимах
ermanaric	германарих
urtaku	уртаки
zito	зито
brioc	бриак
buronson	буронсон
shorkaror	шеракарер
polyperchon	полиперхон
stańczyk	станчик
seungri	сынри
tato	тато
rahere	раэри
radagaisus	радагайс
fibonacci	фибоначчи
hansken	ханскен
ammuna	аммуна
sennacherib	синаххериб
abhinavagupta	абхинавагупта
enkū	энку
xenocles	ксенокл
radegund	радегунда
heffter	гефтер
cynane	кинана
xanthippe	ксантиппа
laches	лахет
gaitana	гайтана
coanacoch	коанакочцин
dohasan	дохасан
elipando	элипанд
twiggy	твигги
gampopa	гампопа
pappo	паппо
hachikō	хатико
miou	миу
kidinnu	кидинну
emygdius	эмигдий
bencion	бенсио
philotas	филота
potap	потап
bolad	болад
juca	жука
pocahontas	покахонтас
costinha	коштинья
brassaï	брассай
nithard	нитгард
asanga	асанга
indutiomarus	индуциомар
zinho	зиньо
ashurbanipal	ашшурбанапал
parmenion	парменион
bhavyaviveka	бхававивека
evagoras	эвагор
agui	агуй
erinna	эринна
brennus	бренн
shahbanu	шахбану
stobaeus	стобей
mongkut	монгкут
zoilus	зоил
tenmon	тэммон
lulinha	лулинья
massiel	массиель
lamachus	ламах
malewiebamani	малиевиебамани
aristillus	аристилл
dobrynya	добрыня
canachus	канах
mcg	макджи
cacamatzin	какамацин
maniche	манише
bucephalus	буцефал
jamukha	джамуха
mazinho	мазиньо
bisinus	бизин
pulcheria	пульхерия
gausbert	госберт
schanz	шанц
milva	мильва
skirgaila	скиргайло
demaratus	демарат
niklot	никлот
vydūnas	видунас
saturnina	сатурнина
czimislav	цзимислав
younha	юнха
sting	стинг
rachilde	рашильд
siemomysł	земомысл
trebellianus	требеллиан
dattus	даттус
abran	абран
onew	оню
kumārajīva	кумараджива
ouida	уида
azarmidokht	азармедохт
archilochus	архилох
zopyrion	зопирион
snuppy	снуппи
pattimura	паттимура
ashanti	ашанти
caribou	карибу
vajiravudh	вачиравудх
triboulet	трибуле
oltos	ольтос
iphicrates	ификрат
zwentibold	цвентибольд
cratylus	кратил
strez	стрез
sponsianus	спонсиан
chintila	хинтила
wiborada	виборада
washakie	вашаки
boudica	боудикка
manucho	манушу
anggun	анггун
britannicus	британник
arash	араш
diponegoro	дипонегоро
theano	феано
nampeyo	нампейо
nimbarka	нимбарка
blandina	бландина
fréhel	фреэль
arwium	арвиум
taliesin	талиесин
sanctorius	санторио
euhemerus	эвгемер
aldair	алдаир
hoelun	оэлун
verginia	виргиния
aspasius	аспасий
kālidāsa	калидаса
joãozinho	жоазиньо
andradina	андрадина
atilia	атилия
miliduch	милидух
malaria	малярия
illtud	ильтуд
djalminha	джалминья
tatikios	татикий
mazaris	мазарис
khabash	хабабаш
pausias	павзий
godeberta	годеберта
anaximander	анаксимандр
campino	кампино
avicii	авичи
manetho	манефон
spitamenes	спитамен
damascius	дамаский
rafinha	рафинья
muhannad	муханнад
polaire	полер
aśvaghoṣa	ашвагхоша
eutropia	евтропия
chimalpahin	чимальпаин
evodius	евод
tissaphernes	тиссаферн
gilla	гилла
fridugisus	фридугис
ishtar	иштар
robinho	робиньо
tharrhypas	таррип
yarlagab	ярлагаб
achaeus	ахей
sadyattes	садиатт
jianzhen	гандзин
mahākāśyapa	махакашьяпа
polybius	полибий
ishpaka	ишпакай
akon	эйкон
tutankhamun	тутанхамон
stesichorus	стесихор
sneferu	снофру
sarlagab	сарлагаб
theudebald	теодебальд
alsou	алсу
pitikwahanapiwiyin	паундмейкер
khufu	хеопс
alecsandro	александро
athracht	аттракта
demosthenes	демосфен
gaugericus	гагерик
machabeli	мачабели
euric	эйрих
hanging	повешение
pujie	пуцзе
allectus	аллект
ralpacan	ралпачан
tostão	тостао
odaenathus	оденат
alluwamna	аллувамна
akhraten	ахратан
commodus	коммод
timoxenos	тимоксен
clodoald	хлодоальд
dingiswayo	дингисвайо
tribonian	трибониан
vicelinus	вицелин
yokozuna	ёкодзуна
genial	жениал
thusnelda	туснельда
flodoard	флодоард
borandukht	борандохт
sitalces	ситалк
mesilim	месилим
zaleucus	залевк
kalumum	калумум
khulan	хулан
madhubala	мадхубала
marlos	марлос
jairzinho	жаирзиньо
onoulphus	онульф
giric	гирик
enheduanna	энхедуанна
reu	рагав
nek	нек
eadmer	эдмер
tadukhipa	тадухепа
sophocles	софокл
zeuxis	зевксис
tolui	толуй
jaimini	джаймини
bardiya	бардия
adherbal	адгербал
nabonidus	набонид
cunimund	кунимунд
bozh	бож
oribasius	орибасий
columba	колумба
etana	этана
zetti	дзетти
hipparchus	гиппарх
arthelais	артелая
senit	сенит
hevia	хевиа
peisistratos	писистрат
strachkvas	страхквас
bregowine	бреговин
natakamani	натакамани
talakhamani	талакамани
sigga	сигга
harpocration	гарпократион
kelis	келис
huiyuan	хуэйюань
craterus	кратер
theudoald	теодоальд
phintias	финтий
mahavira	махавира
mandakini	мандакини
herihor	херихор
bénabar	бенабар
papaflessas	папафлессас
tenevil	теневиль
onomarchus	ономарх
bodawpaya	бодопайя
dexippus	дексипп
aristion	аристион
pleistarchus	плистарх
timoleon	тимолеонт
hostilian	гостилиан
hermonax	гермонакс
philolaus	филолай
tulsidas	тулсидас
aeschylus	эсхил
ahaz	ахаз
samonas	самона
uzziah	озия
euronymous	евронимус
godepert	годеперт
vrčak	врчак
milarepa	миларепа
lutipri	лутипри
googoosh	гугуш
jien	дзиэн
gritsamada	гритсамада
hipponax	гиппонакт
mabyn	мабенна
cynewald	киневальд
tantamani	тануатамон
akeboshi	акэбоси
geberic	геберих
scholastica	схоластика
jovinus	иовин
ekkathat	экатхат
treniota	тройнат
lapu	лапу
pantaenus	пантен
islaja	ислайя
pinehesy	панехси
critias	критий
gallienus	галлиен
richimund	рехимунд
actaeon	актеон
tankei	танкэй
sozomen	созомен
tassac	тассах
croesus	крёз
suelo	суэло
vieirinha	виейринья
ay	эйе
zelão	зелао
betão	бетао
buddhadasa	буддхадаса
nongqawuse	нонгкавусе
theudis	теудис
endoeus	эндой
glele	глеле
elulu	элили
budgie	баджи
weegee	уиджи
sunniva	суннива
owon	овон
butigeidis	будикид
macrinus	макрин
longchenpa	лонгченпа
audomar	аудомар
aenesidemus	энесидем
keirrison	кейррисон
eupolis	евполид
cypselus	кипсел
nǃxau	нкъхау
placentinus	плацентин
gildas	гильда
pasquitan	паскветен
shitao	шитао
squanto	сквонто
glaucetas	главкет
prasutagus	прасутаг
merikare	мерикара
hakor	ахорис
nilmar	нилмар
maironis	майронис
shebitku	шабатака
chulalongkorn	чулалонгкорн
stendhal	стендаль
dignāga	дигнага
elagabalus	гелиогабал
kajol	каджол
hypsicles	гипсикл
albucilla	альбуцилла
muratsan	мурацан
tarrare	таррар
tertullian	тертуллиан
nearchus	неарх
visunarat	висунарат
tarkan	таркан
heraclianus	гераклиан
amanineteyerike	аманинетеиерике
švitrigaila	свидригайло
chinesinho	шинесиньо
evridiki	эвридики
adalberon	адальберон
alcuin	алкуин
ravachol	равашоль
kaidu	хайду
lydos	лидос
puresh	пуреш
gilgamesh	гильгамеш
paracelsus	парацельс
vecchietta	веккьетта
abanoub	анувий
skrillex	скриллекс
frederuna	фредеруна
hatshepsut	хатшепсут
jogaila	ягайло
willibrord	виллиброрд
armatus	армат
richarlyson	ришарлисон
algodão	алгодао
ataulf	атаульф
amphibalus	амфибал
eratosthenes	эратосфен
pythagoras	пифагор
godigisel	годагисл
dentinho	дентиньо
sariputta	шарипутра
censorinus	цензорин
tarako	тарако
wenxiu	вэньсю
morgause	моргауза
guercino	гверчино
odoacer	одоакр
eurymedon	эвримедон
anastacia	анастейша
lactantius	лактанций
megasthenes	мегасфен
triduana	тридуана
sisebut	сисебут
sahure	сахура
iltutmish	илтутмиш
perdigon	пердигон
pelopidas	пелопид
mogol	могол
rivaldo	ривалдо
somerled	сомерлед
echion	аэтион
meskalamdug	мескаламдуг
huineng	хуэйнэн
victricius	виктриций
cædmon	кэдмон
zotto	зотто
toqta	тохта
shattiwaza	шаттиваза
alghu	алгу
hyperbatas	гипербат
polycrates	поликрат
peithon	пифон
hunefer	хунефер
staurakios	ставракий
remismund	ремисмунд
deiotarus	дейотар
alemão	алемао
theramenes	ферамен
mistinguett	мистингетт
ebroin	эброин
posidonius	посидоний
psalmodius	псалмодий
xuanzang	сюаньцзан
vetranio	ветранион
turgesius	тургейс
cherepanovs	черепановы
quartus	куарт
sunderolt	зундерольд
audovera	аудовера
tlacaelel	тлакаелель
amalaric	амаларих
alahis	алагис
telipinu	телепину
bindusara	биндусара
tjokroaminoto	чокроаминото
tacfarinas	такфаринат
karigaila	каригайло
bebeto	бебето
parmenides	парменид
lemmy	лемми
chilaun	чилаун
kujira	кудзира
bourvil	бурвиль
ingund	ингунда
nakhshabi	нахшаби
siamun	сиамон
aneirin	анейрин
stotzas	стотца
pharaildis	фараильда
chafurin	тяфурин
valamir	валамир
alopen	алобэнь
maughold	могольд
neferkahor	неферкахор
brandãozinho	бранданзиньо
domenichino	доменикино
sabium	сабиум
samium	самиум
tekuder	текудер
pytheas	пифей
joselu	хоселу
charidemus	харидем
huitzilihuitl	уилицилипутль
mahalalel	малелеил
bassianus	бассиан
burebista	буребиста
srinagarindra	шринагариндра
erukhan	ерухан
romaric	ромарик
liédson	лиедсон
bâkî	бакы
huni	хуни
superfecundation	суперфекундация
babyface	бэйбифейс
karunesh	карунеш
alcman	алкман
neot	неот
franciabigio	франчабиджо
megacles	мегакл
teru	тэру
sangharakshita	сангхаракшита
belisarius	велисарий
ealdred	элдред
ḫaldi	халди
yajnavaraha	яджнавараха
donncoirce	доннкорки
peirol	пейроль
tirigan	тирикан
quiteria	квитерия
narseh	нарсе
shanice	шанис
yukana	юкана
djedefre	джедефра
chormaqan	чормаган
faxian	фасянь
minervina	минервина
charmadas	хармад
tatian	татиан
arabo	арабо
candrakīrti	чандракирти
sisenand	сисенанд
dembei	денбей
scribonia	скрибония
daskalogiannis	даскалояннис
wallia	валия
sitamun	ситамон
yasu	ясу
dinostratus	динострат
aregund	арнегунда
acamapichtli	акамапичтли
birutė	бирута
majorian	майориан
mariamne	мариамна
mamai	мамай
chlodomer	хлодомир
kerlon	керлон
ingulf	ингульф
indulf	индульф
laelianus	лелиан
cacau	какау
dequinha	декинья
carausius	караузий
alcibiades	алкивиад
benkei	бэнкэй
ramakrishna	рамакришна
psammuthes	псаммут
caçapa	касапа
zizinho	зизиньо
nynetjer	нинечер
veerappan	вираппан
madius	мадий
vidyapati	видьяпати
cottius	коттий
stoya	стоя
satanta	сатанта
jamala	джамала
sayana	саяна
japheth	иафет
liliuokalani	лилиуокалани
thiruvalluvar	тируваллувар
hucbert	хукберт
setnakhte	сетнахт
hephaestion	гефестион
rembrandt	рембрандт
copsi	копси
ahuitzotl	ауисотль
gunderic	гундерих
saichō	сайтё
bagoas	багой
anitta	анитта
shivaji	шиваджи
vytenis	витень
nangklao	чессадабодиндра
limahl	лимал
vampiro	вампиро
anstrudis	анструда
madhvacharya	мадхва
sanai	санаи
ibson	ибсон
dausprungas	довспрунк
ragenfrid	рагенфред
leonnatus	леоннат
ennin	эннин
erispoe	эриспоэ
mazaeus	мазей
icarus	икар
sampiro	сампиро
dalida	далида
baderic	бадерих
deco	деку
epaminondas	эпаминонд
lycophron	ликофрон
zequinha	зекинья
mustis	мустис
siamanto	сиаманто
libanius	либаний
chararic	харарих
mariza	мариза
unkei	ункэй
morcar	моркар
soko	соко
dengizich	денгизик
alalngar	аллалгар
euctemon	евктемон
ninshō	нинсё
fredegund	фредегонда
acusilaus	акусилай
protagoras	протагор
alimqul	алимкул
taibuga	тайбуга
wansa	ванса
balista	баллиста
rehoboam	ровоам
gondioc	гундиох
hirohito	хирохито
shahzoda	шахзода
ostromir	остромир
ospitone	госпитон
gungunhana	гунгунхана
kshemaraja	кшемараджа
averno	аверно
zalmoxis	залмоксис
shamarpa	шамарпа
recceswinth	реккесвинт
aristander	аристандр
rāhula	рахула
baysonqor	байсонкур
erwig	эрвиг
armik	армик
theocritus	феокрит
teleclus	телекл
furqat	фуркат
bzikebi	бзикеби
anthemiolus	антемиол
origa	орига
angulimala	ангулимала
putyata	путята
ariovistus	ариовист
diocletian	диоклетиан
esarhaddon	асархаддон
netjerkare	нечерикара
jonghyun	джонхён
sarbel	сарбель
arnobius	арнобий
xenarchos	ксенарх
masaniello	мазаньелло
interpol	интерпол
morman	морван
pithana	питхана
megabates	мегабат
gunner	ганнер
jochi	джучи
shaushtatar	шауштатар
pontormo	понтормо
thrasybulus	фрасибул
tjodalv	тьодальв
vikramāditya	викрамадитья
josemi	хосеми
tonyukuk	тоньюкук
catald	катальд
perctarit	бертари
myōe	мёэ
canário	канарио
thrasamund	тразамунд
isocrates	исократ
viestards	виестартс
periander	периандр
clodoaldo	клодоалдо
barbatio	барбацион
edigu	едигей
melchizedek	мелхиседек
angilbert	ангильберт
rekhmire	рехмира
ghezo	гезо
smaragdus	смарагд
novatian	новациан
ronglu	жунлу
tahurwaili	тахурваили
kitbuqa	китбука
zanabazar	дзанабадзар
alaungpaya	алаунпайя
mista	миста
cnebba	кнебба
gorgias	горгий
leivinha	лейвинья
yashpal	яшпал
irnerius	ирнерий
mana	мана
erridupizir	эрридупизир
viriathus	вириат
jádson	жадсон
epimenides	эпименид
tisias	тисий
nicias	никий
mélésville	мелесвиль
sacagawea	сакагавея
archippus	архипп
calocaerus	калокер
topsy	топси
ferron	фэррен
athenaeus	афиней
dicaearchus	дикеарх
vaišvilkas	войшелк
maru	мару
philetaerus	филитер
munderic	мундерих
bimbisara	бимбисара
chabrias	хабрий
athaliah	гофолия
lacuzon	лакюзон
ilsinho	илсиньо
pentonville	пентонвиль
mahendravarman	махендраварман
rhipsime	рипсимэ
anaxander	анаксандр
raginpert	рагинперт
vulca	вулка
derlei	дерлей
origen	ориген
catanha	катанья
posidippus	посидипп
chindasuinth	хиндасвинт
berossus	берос
shepseskaf	шепсескаф
apuleius	апулей
heremigarius	хермигар
subandrio	субандрио
thurisind	торисвинт
hauschka	хаушка
baruc	баррук
hizaki	хидзаки
jivani	дживани
kisaki	кисаки
vazul	вазул
teispes	теисп
walthari	вальтари
synesius	синезий
coluche	колюш
babur	бабур
hermeric	хермерих
buriana	буриана
hegesippus	егесипп
malbim	малбим
zumbi	зумби
ingenuus	ингенуй
buddhaghosa	буддхагхоша
kurszán	курсан
setthathirath	сеттатират
zoroaster	заратустра
enchin	энтин
anugama	анугама
buddhapālita	буддапалита
momik	момик
naldo	налдо
aisiqi	айсыци
rechila	рехила
wacho	вахо
maxentius	максенций
galerius	галерий
histiaeus	гистией
kirta	кирта
kiesewetter	кизеветтер
rashi	раши
kaʻahumanu	каауману
ingelger	ингельгер
moralia	моралии
bilichild	билихильда
nayer	найер
lacedaimonius	лакедемоний
frumar	фрумар
cyriades	кириад
ursmar	урсмар
cercamon	серкамон
ibycus	ивик
philopoemen	филопемен
russya	руся
eleutherius	элефтерий
padmasambhava	падмасамбхава
merenhor	меренхор
dagoberto	дагоберто
adunis	адонис
alcinous	алкиной
astrix	астрикс
chisu	кису
herophilos	герофил
giorgione	джорджоне
theodwin	теодвин
teleutias	телевтий
sylvinho	силвиньо
phocion	фокион
chanakya	чанакья
hyperbolus	гипербол
ansprand	анспранд
axayacatl	ашаякатль
sennedjem	сеннеджем
wilgefortis	вильгефортис
mzilikazi	мзиликази
khidr	хидр
fritigern	фритигерн
engelberga	ангельберга
curiatius	куриации
shanakdakhete	шанакдакете
eraric	эрарих
cuitláhuac	куитлауак
banksy	бэнкси
tomatito	томатито
lembitu	лембиту
bryher	брайхер
theodahad	теодахад
ceará	сеара
cleanthes	клеанф
poonthanam	пунтханам
narses	нарсес
garou	гару
wittiza	витица
gobryas	гобрий
euripides	еврипид
tukaram	тукарам
gudula	гудула
theudigisel	теудигизел
hergé	эрже
vaidila	войдило
thrasco	дражко
trugernanner	труганини
etto	этто
pisanello	пизанелло
aurangzeb	аурангзеб
chrysippus	хрисипп
erasistratus	эрасистрат
zenobia	зенобия
banine	банин
hadise	хадисе
pami	пами
novalis	новалис
serchmaa	сэрчмаа
bigode	бигоде
genseric	гейзерих
hotepsekhemwy	хотепсехемуи
herodias	иродиада
matuzalém	матузалем
seryoga	серёга
rimush	римуш
caupolicán	кауполикан
reineldis	рейнельда
hermippus	гермипп
chimalpopoca	чимальпопока
galba	гальба
boediono	будионо
syphax	сифакс
romário	ромарио
antiphanes	антифан
eadwig	эдвиг
skanderbeg	скандербег
sengzhao	сэнчжао
vampeta	вампета
gimax	джимакс
báb	баб
nostradamus	нострадамус
leilton	леилтон
callicrates	калликрат
amelius	амелий
ictinus	иктин
rechiar	рехиар
aldhelm	альдхельм
imi	ими
everaldo	эвералдо
caravelli	каравелли
roxelana	роксолана
eubulides	евбулид
cicinho	сисиньо
hicetas	гикет
euphronios	евфроний
apoño	апоньо
niginho	нижиньо
eminem	эминем
burgundofara	бургондофара
guillemundus	гильемунд
tudwal	тудвал
fininho	фининьо
rigunth	ригунта
souphanouvong	суфанувонг
onesimus	онисим
artashumara	арташшумара
kimbra	кимбра
locusta	локуста
comanche	команч
acius	акий
ratislaus	ратислав
wols	вольс
onir	онир
dondinho	дондиньо
vedast	ведаст
alciphron	алкифрон
tilopa	тилопа
hachiun	хачиун
masaccio	мазаччо
maldras	мальдра
themistius	фемистий
nonnosus	ноннос
flea	фли
genshin	гэнсин
wilopo	вилопо
hierocles	гиерокл
quintillus	квинтилл
enya	эния
nabonassar	набонасар
ruffian	резвая
śāntarakṣita	шантаракшита
leosthenes	леосфен
manuchehri	манучехри
maimonides	маймонид
abbán	аббан
chingünjav	чингунжав
rikishi	рикиши
ashoka	ашока
exekias	эксекий
maudgalyayana	маудгальяяна
stasinus	стасин
eurycrates	еврикрат
uldin	улдин
aedesius	эдесий
mashda	машда
sadigjan	садыхджан
lulach	лулах
kūkai	кукай
satprem	сатпрем
agabus	агав
eisai	эйсай
merneptah	мернептах
frankmusik	фрэнкмьюзик
sanila	санила
galswintha	галесвинта
paíto	паиту
austol	аустоль
balto	балто
chremonides	хремонид
jamba	жамба
hesiod	гесиод
sappho	сапфо
euthymides	евфимид
glycerius	глицерий
lucebert	люсеберт
grafite	графите
salvian	сальвиан
ciara	сиара
fenestella	фенестелла
cytherea	цитерия
leeteuk	итхык
tarpeia	тарпея
gundobad	гундобад
prodicus	продик
silbannacus	силбаннак
isutoshi	исутоси
averroism	аверроизм
balthus	бальтюс
rakim	раким
pollo	польо
hemiunu	хемиун
serug	серух
aryabhata	ариабхата
balih	балих
nabis	набис
datis	датис
anvari	анвари
amanitore	аманиторе
sheram	шерам
sadalberga	салаберга
gundemar	гундемар
shivini	шивини
pyrrho	пиррон
shinran	синран
taixu	тайсюй
shunkan	сюнкан
aistulf	айстульф
ulanhu	уланьфу
shabaka	шабака
sudharmono	судармоно
itta	итта
manvydas	монтвид
arvandus	арванд
farinelli	фаринелли
visakha	вишакха
naplanum	напланум
pelops	пелоп
gaddar	гаддар
kamose	камос
iambulos	ямбул
cleitarchus	клитарх
waltrude	вальдетруда
andrianampoinimerina	андрианампуанимерина
babrius	бабрий
stenkil	стенкиль
donatello	донателло
fulcran	фулькран
rihanna	рианна
lysimachus	лисимах
cratinus	кратин
democritus	демокрит
authari	аутари
aspasia	аспасия
herostratus	герострат
ricardinho	рикардиньо
anandavardhana	анандавардхана
menaechmus	менехм
aspar	аспар
piye	пианхи
psiax	псиакс
himelin	химелин
phrynichus	фриних
theispas	тейшеба
bulchan	блучан
harthacnut	хардекнуд
digão	дигао
methuselah	мафусаил
arrian	арриан
menua	менуа
nominoe	номиноэ
taharqa	тахарка
chram	храмн
khyan	хиан
nemarluk	немарлук
zózimo	зозимо
jeconiah	иехония
critolaus	критолай
nennius	ненний
matisyahu	матисьяху
trocundus	трокунд
sassacus	сассакус
asclepiad	асклепиады
paramartha	чжэньди
terentia	теренция
jebe	джэбэ
mido	мидо
incitatus	инцитат
chandidas	чандидас
shantideva	шантидэва
gaykhatu	гайхату
neferkauhor	неферкаухор
qulpa	кульпа
temnozor	темнозорь
estakhri	истахри
rudaki	рудаки
fulvia	фульвия
nezahualpilli	несауальпилли
nezahualcoyotl	несауалькойотль
liutpert	лиутперт
thucydides	фукидид
ardo	ардо
soeprapto	супрапто
mundus	мунд
ermenguer	эрменгер
jasmuheen	джасмухин
tyrtaeus	тиртей
dobrotitsa	добротица
quini	кини
isaeus	исей
rededya	редедя
socks	сокс
sobekneferu	нефрусобек
elano	элано
momus	момус
philostorgius	филосторгий
wasashatta	васашатта
amanikhabale	аманихабале
manishtushu	маништушу
lulu	лулу
demasduit	демасдуит
bonosus	боноз
shaggy	шэгги
shakira	шакира
laika	лайка
draco	дракон
callicratidas	калликратид
eknath	экнатх
muqali	мухали
apries	априй
rutebeuf	рютбёф
hunna	гунна
yovanna	йованна
rodoald	родоальд
emenon	эменон
timocharis	тимохарис
phraortes	фраорт
herodotus	геродот
riothamus	риотам
nanthild	нантильда
unsuri	унсури
jarboe	джарбо
caracalla	каракалла
herodorus	геродор
piankh	пианх
tonel	тонел
huáscar	уаскар
toyen	тойен
idmon	идмон
brasidas	брасид
ikunum	икунум
suintila	свинтила
sosei	сосэй
slash	слэш
juanes	хуанес
kekaumenos	кекавмен
decebalus	децебал
hypatia	гипатия
malú	малу
govi	гови
pleistoanax	плистоанакт
charmides	хармид
amenmesse	аменмес
gangotri	ганготри
palladas	паллад
agatharchus	агафарх
boroldai	бурундай
abulak	абулак
gungunum	гунгунум
aristoxenus	аристоксен
omarion	омарион
béhanzin	беханзин
mellitus	меллит
naresuan	наресуан
jugurtha	югурта
fabão	фабан
thurcytel	туркетиль
harsiotef	горсиотеф
cochise	кочис
seljuk	сельджук
himiko	химико
cucuphas	кукуфас
osceola	оцеола
cleph	клеф
menkare	менкара
pamprepius	пампрепий
aioulf	агривульф
hidulf	хидульф
emika	эмика
fernandinho	фернандиньо
onkelos	онкелос
akihito	акихито
polyaenus	полиэн
devota	девота
sibawayh	сибавейхи
bardaisan	бардесан
koceľ	коцел
drahomíra	драгомира
canaletto	каналетто
tsunku	цунку
regalianus	регалиан
iamblichus	ямвлих
lunalilo	луналило
musidora	мюзидора
cinioch	киниох
alferius	алферио
pratinas	пратин
kanzi	канзи
ferdowsi	фирдоуси
amyrtaeus	амиртей
kalākaua	калакауа
itzcoatl	ицкоатль
samoth	самот
henjo	хэндзё
barquq	баркук
onesicritus	онесикрит
ionatana	ионатана
ramanuja	рамануджа
sompou	сомпху
prachanda	прачанда
gugunava	гугунава
detsl	децл
jakuren	дзякурэн
kalomira	каломира
oceana	осеана
parsbit	парсбит
ryback	райбек
userkaf	усеркаф
sirikit	сирикит
tyagaraja	тьягараджа
jovian	иовиан
pruden	пруден
thankmar	танкмар
varāhamihira	варахамихира
yennenga	йененга
arnoald	арноальд
tintoretto	тинторетто
mañjuśrīmitra	манджушримитра
regiomontanus	региомонтан
carneades	карнеад
copi	копи
hatuey	атуэй
kesha	кеша
rainivoninahitriniony	райнивунинахитриниуни
ricfried	рикфрид
amanikhatashan	аманикаташан
cuilén	кулен
arikhankharer	ариканкарер
onesilus	онесил
corippus	корипп
pheidippides	фидиппид
kandalanu	кандалану
marcabru	маркабрюн
kuchum	кучум
epaphroditus	епафродит
maïwenn	майвенн
ligalize	лигалайз
živinbudas	живибунд
ryan	райан
scott	скотт
federico	федерико
roberto	роберто
johnson	джонсон
barbara	барбара
enrico	энрико
franco	франко
giuseppe	джузеппе
brad	брэд
alfred	альфред
steve	стив
goran	горан
palladius	палладий
liu	лю
giacomo	джакомо
milan	милан
andy	энди
nicole	николь
donald	дональд
vincenzo	винченцо
amanda	аманда
gunnar	гуннар
jennifer	дженнифер
emma	эмма
santiago	сантьяго
ben	бен
trevor	тревор
nigel	найджел
fritz	фриц
jack	джек
norbert	норберт
harris	харрис
glenn	гленн
kevin	кевин
shane	шейн
terry	терри
anita	анита
jason	джейсон
luigi	луиджи
miller	миллер
adam	адам
jerzy	ежи
alessandro	алессандро
smith	смит
oliver	оливер
jones	джонс
marina	марина
andrzej	анджей
bobby	бобби
nina	нина
zhang	чжан
mika	мика
pietro	пьетро
anders	андерс
andrea	андреа
tobias	тобиас
max	макс
thomas	томас
sandra	сандра
brett	бретт
keller	келлер
moore	мур
willis	уиллис
lars	ларс
alejandro	алехандро
aristophanes	аристофан
samo	само
takashi	такаси
zdeněk	зденек
hiroshi	хироси
carlo	карло
cole	коул
carter	картер
lisa	лиза
gardner	гарднер
hall	холл
dana	дана
arturo	артуро
mario	марио
ivo	иво
salvatore	сальваторе
kyle	кайл
williams	уильямс
didier	дидье
skalmantas	сколоменд
timbaland	тимбалэнд
nammalvar	наммальвар
chuck	чак
parker	паркер
schmidt	шмидт
tadeusz	тадеуш
géza	геза
nelson	нельсон
king	кинг
nancy	нэнси
dennis	деннис
rodolfo	родольфо
gustavo	густаво
marcel	марсель
dieter	дитер
allen	аллен
alain	ален
jackson	джексон
white	уайт
maurice	морис
nick	ник
jessica	джессика
mick	мик
tommaso	томмазо
guillermo	гильермо
gibson	гибсон
jānis	янис
darren	даррен
rolf	рольф
james	джеймс
warren	уоррен
tom	том
dragan	драган
jules	жюль
john	джон
phil	фил
brendan	брендан
tyler	тайлер
imre	имре
zoran	зоран
martina	мартина
simpson	симпсон
riley	райли
adriano	адриано
andrew	эндрю
olivier	оливье
marek	марек
boris	борис
nenad	ненад
colin	колин
alan	алан
xu	сюй
ford	форд
renato	ренато
roth	рот
francesco	франческо
meir	меир
wojciech	войцех
josip	йосип
grant	грант
norman	норман
dejan	деян
jörg	йорг
takahashi	такахаси
dino	дино
george	джордж
tommy	томми
wood	вуд
timo	тимо
todd	тодд
josh	джош
wolfgang	вольфганг
wright	райт
antonín	антонин
zbigniew	збигнев
ashley	эшли
boyd	бойд
rita	рита
adler	адлер
ingrid	ингрид
spencer	спенсер
evans	эванс
william	уильям
anderson	андерсон
ramos	рамос
ron	рон
hill	хилл
carmen	кармен
anton	антон
bartolomeo	бартоломео
joyce	джойс
liam	лиам
predrag	предраг
željko	желько
horst	хорст
kathleen	кэтлин
andreas	андреас
ferenc	ференц
larry	ларри
amir	амир
andersen	андерсен
shirley	ширли
patrice	патрис
alex	алекс
virginia	вирджиния
byron	байрон
ruslan	руслан
harald	харальд
einar	эйнар
matti	матти
barnes	барнс
zhou	чжоу
kobayashi	кобаяси
audrey	одри
darko	дарко
sándor	шандор
janne	янне
nakamura	накамура
logan	логан
walsh	уолш
wagner	вагнер
knut	кнут
armstrong	армстронг
derek	дерек
ross	росс
olga	ольга
gaetano	гаэтано
jeremy	джереми
cohen	коэн
girolamo	джироламо
clifford	клиффорд
mirza	мирза
miklós	миклош
lajos	лайош
rebecca	ребекка
christopher	кристофер
greg	грег
suzuki	судзуки
roman	роман
inoue	иноуэ
sanders	сандерс
stig	стиг
erin	эрин
berry	берри
tanaka	танака
ettore	этторе
marcello	марчелло
peggy	пегги
rex	рекс
chavchavadze	чавчавадзе
west	уэст
hiroyuki	хироюки
gina	джина
jim	джим
kenny	кенни
bojan	боян
valentina	валентина
arnold	арнольд
vicente	висенте
dawson	доусон
karen	карен
edgar	эдгар
chris	крис
ernesto	эрнесто
jens	йенс
williamson	уильямсон
piero	пьеро
dimitrios	димитриос
massimo	массимо
newton	ньютон
cynthia	синтия
giuliano	джулиано
pascal	паскаль
robinson	робинсон
bella	белла
vernon	вернон
wayne	уэйн
morton	мортон
mitchell	митчелл
paavo	пааво
barrett	барретт
oswald	освальд
meredith	мередит
gao	гао
fontana	фонтана
drake	дрейк
hu	ху
alexis	алексис
glen	глен
hansen	хансен
stone	стоун
phillips	филлипс
janusz	януш
edwards	эдвардс
bruce	брюс
jacek	яцек
wilkinson	уилкинсон
maurizio	маурицио
akira	акира
norris	норрис
juraj	юрай
edmund	эдмунд
doris	дорис
kenji	кэндзи
wim	вим
petra	петра
zhao	чжао
sue	сью
tito	тито
ivica	ивица
fox	фокс
jana	яна
morgan	морган
gerhard	герхард
chen	чэнь
istván	иштван
jane	джейн
ivan	иван
cliff	клифф
harvey	харви
mike	майк
perry	перри
sheridan	шеридан
sterling	стерлинг
dušan	душан
brothers	братья
wei	вэй
armando	армандо
patrick	патрик
alberto	альберто
cooper	купер
bill	билл
rupert	руперт
rosenthal	розенталь
svetlana	светлана
gérard	жерар
porter	портер
dick	дик
eugène	эжен
sam	сэм
antanas	антанас
stella	стелла
alicia	алисия
egon	эгон
sherman	шерман
witold	витольд
brennan	бреннан
quinn	куинн
ion	ион
ragnar	рагнар
ashikaga	асикага
rory	рори
lance	лэнс
morten	мортен
saadi	саади
vittorio	витторио
lennart	леннарт
whitney	уитни
jovan	йован
gero	геро
slobodan	слободан
gu	гу
holden	холден
traoré	траоре
emilio	эмилио
liang	лян
davide	давиде
aldo	альдо
snow	сноу
ruslana	руслана
hartley	хартли
fuchs	фукс
holger	хольгер
julián	хулиан
derrick	деррик
gino	джино
lara	лара
hernán	эрнан
baxter	бакстер
alexandros	александрос
aaron	аарон
lewis	льюис
domenico	доменико
robbins	роббинс
tibor	тибор
bell	белл
vanessa	ванесса
richardson	ричардсон
hart	харт
mariano	мариано
ward	уорд
powell	пауэлл
otto	отто
gordon	гордон
filippo	филиппо
zoltán	золтан
sven	свен
butler	батлер
walton	уолтон
fuller	фуллер
gregor	грегор
hunter	хантер
will	уилл
mann	манн
crawford	кроуфорд
lloyd	ллойд
laurent	лоран
von	фон
thornton	торнтон
barker	баркер
lauri	лаури
radu	раду
bauer	бауэр
schneider	шнайдер
moshe	моше
olivia	оливия
koch	кох
roberts	робертс
sammy	сэмми
rubin	рубин
banks	бэнкс
rod	род
jenna	дженна
jenkins	дженкинс
griffin	гриффин
palmer	палмер
tim	тим
felice	феличе
tamara	тамара
jános	янош
serge	серж
carpenter	карпентер
robertson	робертсон
joshua	джошуа
andersson	андерссон
bradley	брэдли
ali	али
zenodorus	зенодор
vince	винс
mariusz	мариуш
pericles	перикл
juris	юрис
ramananda	рамананда
zemfira	земфира
neferkamin	неферкамин
farrell	фаррелл
rodney	родни
polemon	полемон
gregg	грегг
meleager	мелеагр
penn	пенн
felgenhauer	фельгенгауэр
ephialtes	эфиальт
deusdedit	деусдедит
rotaru	ротару
włodzimierz	влодзимеж
vitellius	вителлий
mitch	митч
art	арт
constantina	константина
salomé	саломе
koryun	корюн
krum	крум
huber	хубер
pausanias	павсаний
mauro	мауро
benedetto	бенедетто
aristippus	аристипп
seka	сека
dante	данте
sosa	соса
hildeprand	гильдепранд
hippias	гиппий
carroll	кэрролл
phaedrus	федр
brenda	бренда
perkins	перкинс
humayun	хумаюн
gelo	гелон
pupienus	пупиен
plutarch	плутарх
sosthenes	сосфен
pertinax	пертинакс
avitus	авит
comgall	комгалл
nolan	нолан
ursicinus	урсицин
prudentius	пруденций
mladen	младен
viola	виола
kaloyan	калоян
ramesses	рамсес
sabinianus	сабиниан
benson	бенсон
ferrari	феррари
nepotianus	непоциан
matt	мэтт
edwin	эдвин
matteo	маттео
chester	честер
flynn	флинн
jonathan	джонатан
bennett	беннетт
collins	коллинз
leonid	леонид
cunningham	каннингем
kapoor	капур
allan	аллан
singh	сингх
hughes	хьюз
miloš	милош
maxwell	максвелл
erich	эрих
jamie	джейми
józsef	йожеф
terence	теренс
duffy	даффи
salvador	сальвадор
avi	ави
griffith	гриффит
paolo	паоло
javier	хавьер
rob	роб
antonio	антонио
bond	бонд
esteban	эстебан
béla	бела
jacobsen	якобсен
pedersen	педерсен
tal	таль
sinclair	синклер
fabrizio	фабрицио
del	дель
preston	престон
lucien	люсьен
rené	рене
claudio	клаудио
samir	самир
kennedy	кеннеди
ruiz	руис
swami	свами
vladimir	владимир
arvid	арвид
erhard	эрхард
naomi	наоми
grzegorz	гжегож
pamela	памела
florian	флориан
hubbard	хаббард
adamson	адамсон
samantha	саманта
dorothy	дороти
morrison	моррисон
axel	аксель
owen	оуэн
cesare	чезаре
ivanov	иванов
moon	мун
germanicus	германик
traidenis	тройден
aleš	алеш
tokhtamysh	тохтамыш
sykes	сайкс
petter	петтер
aldegonde	адельгунда
vitalian	виталиан
hilderic	хильдерих
gianluca	джанлука
habakkuk	аввакум
kiko	кико
giottino	джоттино
theophanu	феофано
gertrude	гертруда
ingo	инго
konstantinos	константинос
hamengkubuwono	хаменгкубувоно
marullus	марулл
santillana	сантильяна
madonna	мадонна
udo	удо
saloninus	салонин
bernd	бернд
sami	сами
ethel	этель
attila	аттила
pasquale	паскуале
meryre	мерира
lydus	лид
fuzûlî	физули
favorinus	фаворин
vainius	воин
douris	дурис
sheldon	шелдон
dida	дида
raí	раи
riphath	рифат
callippus	каллипп
nuno	нуну
adalgis	адельхиз
persius	персий
maggie	мэгги
teddy	тедди
donna	донна
capucho	капушу
takeshi	такэси
branislav	бранислав
walters	уолтерс
schmid	шмид
humfrid	гумфрид
theodelinda	теоделинда
titian	тициан
hippo	гиппон
kaká	кака
aureolus	авреол
ante	анте
eusébio	эйсебио
holly	холли
guntram	гунтрамн
gundoald	гундовальд
taurinus	таврин
korniliy	корнилий
frança	франса
lawson	лоусон
roderic	родерих
cleon	клеон
ludger	людгер
charlot	шарло
andocides	андокид
bronisław	бронислав
makron	макрон
thrasyllus	фрасилл
mehdi	мехди
appian	аппиан
sigeric	сигерик
jari	яри
jubal	иувал
æthelweard	этельвард
jill	джилл
ana	ана
lorenz	лоренц
lina	лина
rick	рик
camillo	камилло
armin	армин
ioannis	иоаннис
yuan	юань
amy	эми
chase	чейз
omar	омар
ray	рэй
brandt	брандт
pekka	пекка
vargas	варгас
hannu	ханну
henri	анри
kārlis	карлис
ellis	эллис
clara	клара
mccarthy	маккарти
karel	карел
alfredo	альфредо
petrov	петров
lászló	ласло
clayton	клейтон
lola	лола
moreira	морейра
shelley	шелли
forrest	форрест
nikita	никита
thierry	тьерри
baker	бейкер
carlos	карлос
robson	робсон
farina	фарина
manning	мэннинг
bernardo	бернардо
dragutin	драгутин
benítez	бенитес
esther	эстер
enzo	энцо
radek	радек
mara	мара
mieczysław	мечислав
mortensen	мортенсен
guerrero	герреро
gregorio	грегорио
joe	джо
madison	мэдисон
adolfo	адольфо
martin	мартин
jordan	джордан
linda	линда
brown	браун
olaf	олаф
ladislav	ладислав
gianfranco	джанфранко
lasse	лассе
feng	фэн
yamashita	ямасита
bellamy	беллами
savage	сэвидж
janko	янко
emery	эмери
miodrag	миодраг
brent	брент
horacio	орасио
adnan	аднан
judy	джуди
daisuke	дайсукэ
matija	матия
panagiotis	панайотис
yoshida	ёсида
jochen	йохен
forster	форстер
ye	е
emanuele	эмануэле
dora	дора
florent	флоран
giordano	джордано
magda	магда
ryszard	рышард
franjo	франьо
aya	ая
amber	эмбер
kerry	керри
dwight	дуайт
emiliano	эмилиано
rasmussen	расмуссен
yamamoto	ямамото
marino	марино
devon	девон
nikos	никос
vallejo	вальехо
peng	пэн
gavin	гэвин
lennon	леннон
andré	андре
ernst	эрнст
thomson	томсон
kim	ким
marvin	марвин
billy	билли
mercedes	мерседес
brooks	брукс
vera	вера
arne	арне
hernández	эрнандес
francesca	франческа
marat	марат
krause	краузе
bertrand	бертран
travis	трэвис
ignacio	игнасио
wilhelm	вильгельм
duff	дафф
galina	галина
atkinson	аткинсон
rosenberg	розенберг
jacqueline	жаклин
sylvain	сильвен
irving	ирвинг
cox	кокс
hudson	хадсон
grace	грейс
juozas	юозас
o	о
lynn	линн
gutiérrez	гутьеррес
joaquín	хоакин
agnieszka	агнешка
nilsson	нильссон
lothar	лотар
morales	моралес
fu	фу
donovan	донован
kazuo	кадзуо
danilo	данило
moreno	морено
müller	мюллер
hicks	хикс
jaan	яан
dumont	дюмон
leighton	лейтон
della	делла
delgado	дельгадо
tucker	такер
otis	отис
søren	сёрен
georg	георг
jacques	жак
osman	осман
randy	рэнди
manuela	мануэла
holt	холт
ken	кен
lena	лена
guido	гвидо
montgomery	монтгомери
lincoln	линкольн
caro	каро
ai	ай
melvin	мелвин
jukka	юкка
kingsley	кингсли
dickinson	дикинсон
sargent	сарджент
schmitt	шмитт
ulf	ульф
cody	коди
dallas	даллас
baruch	барух
brock	брок
sánchez	санчес
wilkins	уилкинс
mary	мэри
kenneth	кеннет
ruth	рут
moses	мозес
marcelo	марсело
lorenzo	лоренцо
wilson	уилсон
marsh	марш
debbie	дебби
larionov	ларионов
hiroki	хироки
aoki	аоки
cornell	корнелл
archie	арчи
janet	джанет
jørgensen	йоргенсен
elvis	элвис
shen	шэнь
dexter	декстер
takeo	такэо
sabrina	сабрина
evan	эван
best	бест
andrija	андрия
bright	брайт
waters	уотерс
trent	трент
melissa	мелисса
nazarov	назаров
antonelli	антонелли
yamada	ямада
bridges	бриджес
cindy	синди
arellano	арельяно
jayavarman	джаяварман
rafał	рафал
gruber	грубер
tyson	тайсон
valentino	валентино
gold	голд
ivana	ивана
potter	поттер
berlin	берлин
tiffany	тиффани
kirsten	кирстен
christos	христос
benno	бенно
matsumoto	мацумото
otakar	отакар
juliusz	юлиуш
watanabe	ватанабэ
honda	хонда
hodgson	ходжсон
shigeru	сигэру
severino	северино
fields	филдс
yutaka	ютака
greenwood	гринвуд
foster	фостер
reyes	рейес
ricci	риччи
spence	спенс
kidd	кидд
andrás	андраш
sebastiano	себастьяно
griffiths	гриффитс
gonzález	гонсалес
cabrera	кабрера
fletcher	флетчер
hope	хоуп
pérez	перес
siegfried	зигфрид
nino	нино
robert	роберт
rubinstein	рубинштейн
françoise	франсуаза
rossi	росси
johann	иоганн
gabriel	габриэль
webb	уэбб
stanley	стэнли
kurt	курт
clive	клайв
watson	уотсон
miroslav	мирослав
varela	варела
calderón	кальдерон
burke	бёрк
henry	генри
jimmy	джимми
suárez	суарес
serra	серра
vieira	виейра
fabre	фабр
rodrigo	родриго
davidson	дэвидсон
ismail	исмаил
manfred	манфред
torres	торрес
morris	моррис
fredrik	фредрик
werner	вернер
thompson	томпсон
martens	мартенс
julien	жюльен
domínguez	домингес
ferdinando	фердинандо
nur	нур
abel	абель
dudley	дадли
brandon	брэндон
bernardino	бернардино
birgit	биргит
mirko	мирко
jake	джейк
frankie	фрэнки
larsen	ларсен
hopkins	хопкинс
fan	фань
gibbons	гиббонс
hal	хэл
aslan	аслан
navarro	наварро
glover	гловер
brittany	бриттани
anja	аня
jiang	цзян
ellen	эллен
anthony	энтони
hutton	хаттон
benjamin	бенджамин
gates	гейтс
compton	комптон
ercole	эрколе
ma	ма
sutherland	сазерленд
lynch	линч
katz	кац
leonardo	леонардо
zimmermann	циммерман
justus	юстус
smirnov	смирнов
pat	пэт
de	де
józef	юзеф
jean	жан
rinpoche	ринпоче
costello	костелло
hilton	хилтон
hammer	хаммер
clyde	клайд
roque	роке
shepard	шепард
olson	олсон
frost	фрост
sweeney	суини
morel	морель
nixon	никсон
ida	ида
zalman	залман
evert	эверт
heikki	хейкки
booth	бут
sigurd	сигурд
perrin	перрен
massey	мэсси
hull	халл
ter	тер
peretz	перец
ottavio	оттавио
stanton	стэнтон
odd	одд
bartlett	бартлетт
darryl	дэррил
mona	мона
ludwig	людвиг
luciano	лучано
mauricio	маурисио
françois	франсуа
pablo	пабло
ferguson	фергюсон
larsson	ларссон
sharif	шариф
dillon	диллон
milton	милтон
charlie	чарли
jerome	джером
danny	дэнни
auguste	огюст
stefano	стефано
katarzyna	катажина
satoshi	сатоси
amano	амано
bent	бент
fink	финк
areobindus	ареобинд
carrie	кэрри
minami	минами
irena	ирена
campos	кампос
okamoto	окамото
heath	хит
rush	раш
weaver	уивер
kovačević	ковачевич
aryeh	арье
buddy	бадди
tina	тина
crane	крейн
woods	вудс
bondarenko	бондаренко
rooney	руни
shaw	шоу
riva	рива
kikuchi	кикути
gemma	джемма
alexa	алекса
kasper	каспер
jussi	юсси
edna	эдна
marini	марини
shalom	шалом
faber	фабер
cannon	кэннон
carly	карли
benton	бентон
ondřej	ондржей
tsutomu	цутому
thanh	тхань
masaru	масару
evaristo	эваристо
les	лес
fiedler	фидлер
katja	катя
mansfield	мэнсфилд
ada	ада
henk	хенк
minoru	минору
linden	линден
alessio	алессио
gökhan	гёкхан
oldřich	олдржих
garner	гарнер
glass	гласс
patton	паттон
bishop	бишоп
hideyuki	хидэюки
mclaren	макларен
chiara	кьяра
tullio	туллио
edoardo	эдоардо
camus	камю
chelsea	челси
mussolini	муссолини
aki	аки
giancarlo	джанкарло
leonidas	леонидас
tokugawa	токугава
ariel	ариэль
kálmán	кальман
dražen	дражен
jackie	джеки
mira	мира
serena	серена
gustafsson	густафссон
gillian	джиллиан
freire	фрейре
len	лен
hideki	хидэки
kimura	кимура
lively	лайвли
ackermann	аккерман
guglielmo	гульельмо
gabriela	габриэла
judd	джадд
silvio	сильвио
juan	хуан
moritz	мориц
leandro	леандро
friedrich	фридрих
ted	тед
harold	гарольд
randolph	рэндольф
morrow	морроу
vivian	вивиан
sextus	секст
browning	браунинг
romuald	ромуальд
holmes	холмс
rivera	ривера
richards	ричардс
sally	салли
august	август
price	прайс
tiberius	тиберий
leonard	леонард
pierre	пьер
emerson	эмерсон
wade	уэйд
holland	холланд
popov	попов
robin	робин
alexandra	александра
greenberg	гринберг
georgia	джорджия
aimé	эме
horton	хортон
hunt	хант
khan	хан
adams	адамс
grimm	гримм
jared	джаред
helen	хелен
hilarion	иларион
romano	романо
jefferson	джефферсон
gerd	герд
hardy	харди
parsons	парсонс
todor	тодор
gideon	гидеон
romero	ромеро
weber	вебер
johnny	джонни
klaus	клаус
austin	остин
bonnie	бонни
gianni	джанни
vsevolod	всеволод
marley	марли
papadopoulos	пападопулос
eldar	эльдар
mikko	микко
watkins	уоткинс
blanco	бланко
mel	мел
ulrich	ульрих
ortiz	ортис
ferdinand	фердинанд
agostino	агостино
love	лав
troy	трой
károly	карой
natasha	наташа
tkachenko	ткаченко
barry	барри
fernando	фернандо
guillaume	гийом
gyula	дьюла
gerald	джеральд
marshall	маршалл
clarence	кларенс
he	хэ
medina	медина
berger	бергер
shah	шах
pereira	перейра
antonia	антония
black	блэк
birger	биргер
bahram	бахрам
everett	эверетт
cleveland	кливленд
gore	гор
wilfred	уилфред
caldwell	колдуэлл
guevara	гевара
taras	тарас
landau	ландау
delaunay	делоне
wilder	уайлдер
giulio	джулио
gunn	ганн
bert	берт
henderson	хендерсон
roderick	родерик
manuel	мануэль
lucius	луций
ahmet	ахмет
ilya	илья
augusto	аугусто
branko	бранко
álvarez	альварес
orlando	орландо
jan	ян
sandro	сандро
georges	жорж
jing	цзин
alison	элисон
marcos	маркос
eduardo	эдуардо
burns	бёрнс
vito	вито
parkinson	паркинсон
estelle	эстель
donaldson	дональдсон
mats	матс
hogan	хоган
gardiner	гардинер
oda	ода
barney	барни
sigurðsson	сигурдссон
aris	арис
amedeo	амедео
acevedo	асеведо
rice	райс
amar	амар
iversen	иверсен
goldsmith	голдсмит
zdravko	здравко
duhamel	дюамель
smart	смарт
balfour	бальфур
hilary	хилари
ned	нед
barber	барбер
fiona	фиона
gibbs	гиббс
zapata	сапата
lombardo	ломбардо
zvonimir	звонимир
hannes	ханнес
watts	уоттс
sverre	сверре
landon	лэндон
finn	финн
mo	мо
per	пер
eaton	итон
wyatt	уайетт
seleucus	селевк
molina	молина
maximilian	максимилиан
valdés	вальдес
héctor	эктор
edmond	эдмон
alfonso	альфонсо
tomislav	томислав
clément	клеман
jovanović	йованович
wallace	уоллес
enver	энвер
floyd	флойд
sharma	шарма
haas	хаас
leopold	леопольд
nathaniel	натаниэль
visconti	висконти
vogel	фогель
louis	луи
jerry	джерри
muñoz	муньос
murphy	мёрфи
arthur	артур
poul	поуль
stanford	стэнфорд
colombo	коломбо
dai	дай
trump	трамп
pollock	поллок
pike	пайк
mustafa	мустафа
hopper	хоппер
elio	элио
sturm	штурм
milošević	милошевич
kalevi	калеви
greer	грир
vlado	владо
wells	уэллс
bohumil	богумил
farmer	фармер
tara	тара
albright	олбрайт
dyer	дайер
loïc	лоик
betsy	бетси
kai	кай
zsolt	жолт
celia	селия
vuk	вук
monroe	монро
pelletier	пеллетье
naoki	наоки
candice	кэндис
eriksen	эриксен
clarkson	кларксон
guan	гуань
yair	яир
powers	пауэрс
bastian	бастиан
borislav	борислав
akiko	акико
seth	сет
malone	мэлоун
ryder	райдер
dylan	дилан
summers	саммерс
star	стар
dolores	долорес
facundo	факундо
peder	педер
raquel	ракель
eulogius	евлогий
romain	ромен
leoni	леони
ewald	эвальд
roussel	руссель
presley	пресли
zvi	цви
sani	сани
davenport	дэвенпорт
németh	немет
church	чёрч
italo	итало
mcgrath	макграт
hanno	ханно
hasegawa	хасэгава
xue	сюэ
das	дас
marilyn	мэрилин
esposito	эспозито
yılmaz	йылмаз
prasad	прасад
wall	уолл
maurer	маурер
lindgren	линдгрен
bao	бао
michelangelo	микеланджело
chalmers	чалмерс
nguyen	нгуен
lois	лоис
masahiro	масахиро
greta	грета
petri	петри
snyder	снайдер
takeda	такэда
megumi	мэгуми
gareth	гарет
masashi	масаси
margit	маргит
corrado	коррадо
tate	тейт
dragoljub	драголюб
auerbach	ауэрбах
yoshio	ёсио
darcy	дарси
endre	эндре
gotō	гото
mateusz	матеуш
namgyal	намгьял
dempsey	демпси
agnelli	аньелли
shlomo	шломо
kwame	кваме
prieto	прието
cassidy	кэссиди
quentin	квентин
nakano	накано
ognjen	огнен
skinner	скиннер
gracie	грейси
braga	брага
moser	мозер
hippocrates	гиппократ
lowell	лоуэлл
child	чайлд
ilan	илан
peck	пек
orozco	ороско
vilém	вилем
buckley	бакли
darling	дарлинг
yasuhiro	ясухиро
jia	цзя
zhen	чжэнь
huntington	хантингтон
qian	цянь
christiansen	кристиансен
empress	императрица
eero	ээро
emmerich	эммерих
hodges	ходжес
vyacheslav	вячеслав
boško	бошко
györgy	дьёрдь
osamu	осаму
thutmose	тутмос
erasmus	эразм
mcqueen	маккуин
valerio	валерио
carrera	каррера
tennant	теннант
mao	мао
redgrave	редгрейв
cáceres	касерес
alla	алла
sasaki	сасаки
xiang	сян
olli	олли
shinji	синдзи
scarlett	скарлетт
cherry	черри
pino	пино
melville	мелвилл
march	марч
leone	леоне
kazys	казис
amnon	амнон
jesper	йеспер
harrington	харрингтон
rosen	розен
armen	армен
junichi	дзюнъити
wirth	вирт
garibald	гарибальд
morita	морита
maeda	маэда
zlatko	златко
iman	иман
kelly	келли
karim	карим
emmanuel	эммануэль
berman	берман
franklin	франклин
fred	фред
franz	франц
lange	ланге
barbosa	барбоза
gilles	жиль
vasile	василе
yaakov	яаков
ferrara	феррара
graham	грэм
antiochus	антиох
roosevelt	рузвельт
emily	эмили
inna	инна
berthold	бертольд
leopoldo	леопольдо
claude	клод
van	ван
mia	миа
jennings	дженнингс
clemens	клеменс
nash	нэш
carson	карсон
lana	лана
hervé	эрве
antti	антти
higgins	хиггинс
rose	роуз
n	н
painter	вазописец
vadim	вадим
gleb	глеб
benito	бенито
mariana	мариана
bravo	браво
lancaster	ланкастер
girard	жирар
jarvis	джарвис
valentin	валентин
al	аль
rachel	рэйчел
becker	беккер
leslie	лесли
carr	карр
simmons	симмонс
ramírez	рамирес
honoré	оноре
fanny	фанни
emanuel	эмануэль
fernández	фернандес
townsend	таунсенд
kendall	кендалл
nikolaos	николаос
ferrer	феррер
köhler	кёлер
connie	конни
zheng	чжэн
terrence	терренс
field	филд
ratibor	ратибор
saarinen	сааринен
schumacher	шумахер
lott	лотт
luce	люс
rauf	рауф
svensson	свенссон
harper	харпер
ville	вилле
teixeira	тейшейра
ezequiel	эсекьель
rolando	роландо
cao	цао
york	йорк
devi	деви
d	д
turner	тёрнер
wanda	ванда
karol	кароль
roy	рой
freeman	фримен
ptolemy	птолемей
lópez	лопес
heinrich	генрих
anna	анна
jorge	хорхе
pasha	паша
bob	боб
acosta	акоста
carver	карвер
helge	хельге
zara	зара
blair	блэр
parra	парра
donner	доннер
strong	стронг
eino	эйно
duarte	дуарте
ilona	илона
judge	джадж
godwin	годвин
marr	марр
naum	наум
gough	гоф
schlesinger	шлезингер
randall	рэндалл
cecil	сесил
bengt	бенгт
norberto	норберто
rudolf	рудольф
victoria	виктория
ivanovich	иванович
ole	оле
starr	старр
giovanni	джованни
rich	рич
nana	нана
wu	у
františek	франтишек
don	дон
newman	ньюман
courtney	кортни
seymour	сеймур
magnus	магнус
adi	ади
innes	иннес
svetozar	светозар
stubbs	стаббс
bellini	беллини
dolan	долан
farley	фарли
guilherme	гильерме
brandão	брандао
glyn	глин
masako	масако
jansson	янссон
valdis	валдис
aldridge	олдридж
morley	морли
chao	чао
motta	мотта
giovanna	джованна
strabo	страбон
casanova	казанова
robles	роблес
ferrero	ферреро
javad	джавад
liz	лиз
ott	отт
shelton	шелтон
finch	финч
sorel	сорель
gintaras	гинтарас
mullen	маллен
rowley	роули
aulus	авл
newell	ньюэлл
edgardo	эдгардо
dyson	дайсон
dietmar	дитмар
peyton	пейтон
ventura	вентура
goodwin	гудвин
whitehead	уайтхед
bartholomew	бартоломью
warner	уорнер
benedetti	бенедетти
galli	галли
pavol	павол
ziegler	циглер
ruby	руби
harding	хардинг
vasilis	василис
wessel	вессель
marit	марит
kelsey	келси
mateo	матео
kid	кид
barlow	барлоу
ilie	илие
serrano	серрано
merkel	меркель
north	норт
marcellinus	марцеллин
waldemar	вальдемар
fleming	флеминг
habib	хабиб
flavius	флавий
wolfram	вольфрам
fielding	филдинг
jenny	дженни
sullivan	салливан
ferreira	феррейра
andrews	эндрюс
jensen	йенсен
jürgen	юрген
erwin	эрвин
miguel	мигель
carla	карла
mir	мир
bartosz	бартош
felipe	фелипе
baba	баба
santana	сантана
norton	нортон
levon	левон
archer	арчер
iglesias	иглесиас
balthasar	бальтазар
hagen	хаген
mathieu	матьё
stafford	стаффорд
anastasia	анастасия
alphonse	альфонс
nicolae	николае
bo	бо
carol	кэрол
angelo	анджело
harry	гарри
willem	виллем
richard	ричард
willibald	виллибальд
ferreri	феррери
kiplagat	киплагат
brunet	брюне
tapio	тапио
bergen	берген
clint	клинт
naoto	наото
emmy	эмми
hua	хуа
bud	бад
kluger	клугер
erkki	эркки
balthild	батильда
antonis	антонис
lamberto	ламберто
xun	сюнь
kawashima	кавасима
miloslav	милослав
aldrich	олдрич
marisa	мариса
dariusz	дариуш
juha	юха
ocampo	окампо
tarasov	тарасов
pastrana	пастрана
thaler	талер
hooper	хупер
hannibal	ганнибал
hancock	хэнкок
phyllis	филлис
đorđević	джорджевич
ba	ба
shay	шей
marlon	марлон
joop	йоп
ginger	джинджер
krzysztof	кшиштоф
almond	алмонд
baiju	байджу
håkan	хокан
vlastimil	властимил
pineda	пинеда
antun	антун
arana	арана
eyal	эяль
pisano	пизано
corinna	коринна
yuichi	юити
hoshino	хосино
handler	хэндлер
stevan	стеван
merle	мерл
zosimus	зосим
merz	мерц
arquette	аркетт
szczęsny	щенсный
jermaine	джермейн
tatsuya	тацуя
remo	ремо
dumitrescu	думитреску
jade	джейд
camacho	камачо
kati	кати
savić	савич
abdoulaye	абдулай
melinda	мелинда
pōmare	помаре
mccoy	маккой
nakayama	накаяма
tammy	тэмми
çetin	четин
murakami	мураками
matsui	мацуи
pinchas	пинхас
tobin	тобин
yoshihiro	ёсихиро
vinson	винсон
biggs	биггс
magomed	магомед
pelé	пеле
marić	марич
apel	апель
ulises	улисес
massimiliano	массимилиано
werth	верт
yukio	юкио
hasler	хаслер
dewey	дьюи
hideo	хидэо
corneliu	корнелиу
ueda	уэда
zane	зейн
marjorie	марджори
kenichi	кэнъити
dodd	додд
ashton	эштон
kemal	кемаль
obradović	обрадович
maron	марон
schumann	шуман
millar	миллар
ibarra	ибарра
inger	ингер
jenő	енё
cimon	кимон
brontë	бронте
benda	бенда
zé	зе
sakata	саката
flemming	флемминг
penny	пенни
maciej	мацей
debra	дебра
crosby	кросби
büchel	бюхель
donati	донати
christensen	кристенсен
firmus	фирм
beat	беат
schell	шелл
bode	боде
sakamoto	сакамото
hao	хао
fitzpatrick	фицпатрик
paddy	пэдди
norma	норма
benny	бенни
célestin	селестен
hampton	хэмптон
bourgeois	буржуа
ekman	экман
pilar	пилар
ertl	эртль
masaki	масаки
eitan	эйтан
coppola	коппола
demidov	демидов
johansen	йохансен
milovan	милован
petre	петре
haris	харис
pfister	пфистер
reuven	реувен
kowalczyk	ковальчик
rocca	рокка
elia	элиа
natsuki	нацуки
underwood	андервуд
mylène	милен
fonda	фонда
chiba	тиба
minnie	минни
maximian	максимиан
tucci	туччи
rybakov	рыбаков
emre	эмре
mcmahon	макмэхон
hirokazu	хирокадзу
flo	фло
bailly	байи
villalobos	вильялобос
jorma	йорма
pardo	пардо
leblanc	леблан
sayaka	саяка
gaillard	гайяр
masayuki	масаюки
akiyama	акияма
eliezer	элиэзер
duško	душко
andrius	андрюс
mile	миле
sepp	зепп
iris	айрис
gheorghiu	георгиу
stanković	станкович
penelope	пенелопа
whitaker	уитакер
urs	урс
hitomi	хитоми
perlman	перлман
thomsen	томсен
espen	эспен
gratian	грациан
foley	фоли
nacho	начо
dorian	дориан
raabe	раабе
contarini	контарини
hussey	хасси
bertram	бертрам
seki	сэки
connolly	коннолли
walcott	уолкотт
gibb	гибб
juho	юхо
swift	свифт
fujita	фудзита
ananda	ананда
woody	вуди
yamaguchi	ямагути
anand	ананд
ishikawa	исикава
igarashi	игараси
sakai	сакаи
fomin	фомин
aguilar	агилар
liliana	лилиана
shalmaneser	салманасар
conti	конти
alessandra	алессандра
baur	баур
toshiro	тосиро
dirk	дирк
davor	давор
zeng	цзэн
benn	бенн
bruch	брух
kojima	кодзима
murad	мурад
hoppe	хоппе
jarkko	яркко
kuzmin	кузьмин
tamás	тамаш
mimi	мими
uroš	урош
emir	эмир
sugiyama	сугияма
lala	лала
lino	лино
messina	мессина
morena	морена
hajime	хадзимэ
lyubov	любовь
mamoru	мамору
reeve	рив
hayashi	хаяси
cope	коуп
rocky	рокки
lux	люкс
czesław	чеслав
gal	галь
lyndon	линдон
masao	масао
lykourgos	ликург
boban	бобан
miyazaki	миядзаки
phoenix	феникс
crespo	креспо
monk	монк
coates	коутс
jindřich	йиндржих
hanson	хансон
sonny	сонни
libor	либор
mefodiy	мефодий
artabasdos	артавазд
tóth	тот
biro	биро
carlson	карлсон
svoboda	свобода
thiago	тиаго
dalla	далла
josie	джози
veneziano	венециано
mildred	милдред
katayama	катаяма
sparks	спаркс
larson	ларсон
loretta	лоретта
egil	эгиль
damiano	дамиано
adriana	адриана
dov	дов
herta	герта
viviani	вивиани
mazurkiewicz	мазуркевич
gerasimov	герасимов
arlen	арлен
juvenalis	ювеналий
zborowski	зборовский
tao	тао
caleb	калеб
fukuda	фукуда
britt	бритт
lombardi	ломбарди
mccartney	маккартни
helms	хелмс
eriksson	эрикссон
ram	рам
britton	бриттон
silver	сильвер
abe	абэ
sheila	шейла
strozzi	строцци
antoine	антуан
no	но
edith	эдит
semyon	семён
curtis	кёртис
douglas	дуглас
jesse	джесси
bruno	бруно
álvaro	альваро
oleg	олег
joão	жуан
dimitrov	димитров
campbell	кэмпбелл
rodríguez	родригес
lucy	люси
taylor	тейлор
vinogradov	виноградов
forbes	форбс
lin	линь
long	лонг
theodosius	феодосий
levan	леван
churchill	черчилль
kerr	керр
sforza	сфорца
reginald	реджинальд
tristan	тристан
urban	урбан
drew	дрю
krešimir	крешимир
niccolò	никколо
lake	лейк
jiří	иржи
dimitar	димитр
ella	элла
luna	луна
theodora	феодора
cyrus	сайрус
friedman	фридман
berg	берг
kumar	кумар
richter	рихтер
timothy	тимоти
hewitt	хьюитт
potocki	потоцкий
agnes	агнес
justin	джастин
alves	алвес
chamberlain	чемберлен
knox	нокс
melanie	мелани
mercier	мерсье
pavel	павел
mehmet	мехмет
claudius	клавдий
nathan	натан
sigismund	сигизмунд
morozov	морозов
diego	диего
ap	ап
emperor	император
villa	вилья
bowen	боуэн
orlova	орлова
denise	дениз
elsa	эльза
bentley	бентли
domingo	доминго
hristo	христо
aguirre	агирре
wilcox	уилкокс
lauren	лорен
bedford	бедфорд
árpád	арпад
václav	вацлав
garnier	гарнье
ronald	рональд
charlotte	шарлотта
mata	мата
ricardo	рикардо
uwe	уве
sokolov	соколов
percy	перси
leo	лео
eberhard	эберхард
sima	сыма
duc	дык
le	ле
wolf	вольф
martínez	мартинес
mircea	мирча
toby	тоби
junko	дзюнко
dustin	дастин
reeves	ривз
stan	стэн
henson	хенсон
yannick	янник
na	на
avigdor	авигдор
ovchinnikov	овчинников
moran	моран
kazakov	казаков
kaiser	кайзер
renner	реннер
grégoire	грегуар
timur	тимур
amelia	амелия
rinaldo	ринальдо
martini	мартини
krishna	кришна
milorad	милорад
bryant	брайант
marlene	марлен
shearer	ширер
redmond	редмонд
hanley	хэнли
gallagher	галлахер
desmond	десмонд
henning	хеннинг
shevchuk	шевчук
joy	джой
schubert	шуберт
sandrine	сандрин
maciel	масиэл
hines	хайнс
colette	колетт
murray	мюррей
barthélemy	бартелеми
jeff	джефф
blaise	блез
palaiologos	палеолог
gilbert	гилберт
justinian	юстиниан
ballard	баллард
goldschmidt	гольдшмидт
attalus	аттал
dorfman	дорфман
lon	лон
daphne	дафна
orr	орр
lebrun	лебрен
oppenheimer	оппенгеймер
yao	яо
keating	китинг
jaak	яак
huffman	хаффман
ivar	ивар
cotton	коттон
xuan	сюань
lyons	лайонс
alina	алина
karina	карина
ants	антс
sanford	сэнфорд
margaret	маргарет
ritter	риттер
annie	энни
kuznetsov	кузнецов
fonseca	фонсека
dorji	дорджи
heinz	хайнц
jérôme	жером
radziwiłł	радзивилл
lindsay	линдсей
gill	гилл
andrés	андрес
borgia	борджиа
vlad	влад
riccardo	риккардо
stirling	стирлинг
perdiccas	пердикка
robbie	робби
nicomedes	никомед
reynolds	рейнольдс
hitler	гитлер
joanna	джоанна
chaplin	чаплин
shankar	шанкар
arcesilaus	аркесилай
amos	амос
karin	карин
bolton	болтон
gloria	глория
zinaida	зинаида
gillespie	гиллеспи
mccormack	маккормак
hyde	хайд
baltasar	бальтасар
bonaparte	бонапарт
barreto	баррето
miranda	миранда
velasco	веласко
abbas	аббас
fyodorov	фёдоров
qi	ци
wesley	уэсли
cheng	чэн
palma	пальма
vakhtang	вахтанг
betty	бетти
flanagan	флэнаган
francis	фрэнсис
antónio	антониу
walker	уокер
hippolyte	ипполит
jaroslav	ярослав
herbert	герберт
victorinus	викторин
laurel	лорел
agricola	агрикола
binder	биндер
ortega	ортега
zenon	зенон
bourke	бурк
alva	альва
harun	харун
kessler	кесслер
berenson	беренсон
burgess	бёрджесс
alberti	альберти
ivor	айвор
monaco	монако
selby	селби
witt	витт
ruffini	руффини
pomponius	помпоний
mato	мато
jaromír	яромир
phelps	фелпс
ruffo	руффо
lewandowski	левандовский
kenan	кенан
boulanger	буланже
taha	таха
coster	костер
prospero	просперо
kern	керн
agüero	агуэро
guntis	гунтис
kamal	камаль
orton	ортон
crispin	криспин
schiff	шифф
ronan	ронан
rasmus	расмус
roll	ролл
bouchard	бушар
fabiano	фабиано
honorius	гонорий
goswami	госвами
eusebio	эусебио
ferris	феррис
megan	меган
gwen	гвен
ender	эндер
afonso	афонсу
ippolito	ипполито
florin	флорин
godwinson	годвинсон
raja	раджа
manolo	маноло
loris	лорис
todorov	тодоров
pierluigi	пьерлуиджи
sutton	саттон
paoli	паоли
dunbar	данбар
bremer	бремер
leonor	леонор
cochrane	кокрейн
darby	дарби
bühler	бюлер
jutta	ютта
petronius	петроний
armas	армас
octave	октав
abba	абба
antoinette	антуанетта
slava	слава
reich	райх
mars	марс
tikhon	тихон
diarra	диарра
romulus	ромул
pam	пэм
weinberg	вайнберг
renard	ренар
ferran	ферран
åke	оке
owens	оуэнс
dix	дикс
pontus	понтус
stoyanov	стоянов
manfredi	манфреди
arce	арсе
márcio	марсио
legrand	легран
ni	ни
alfaro	альфаро
ginzburg	гинзбург
fernanda	фернанда
sigrid	сигрид
christer	кристер
radomir	радомир
paz	пас
olivera	оливера
manson	мэнсон
mill	милль
paterson	патерсон
devin	девин
bonham	бонэм
kaarlo	каарло
knudsen	кнудсен
eliyahu	элияху
portillo	портильо
yui	юи
hermogenes	гермоген
alma	альма
chiaki	тиаки
wadsworth	уодсворт
issa	исса
coe	коу
dainis	дайнис
väinö	вяйнё
dorn	дорн
luca	лука
melchior	мельхиор
vázquez	васкес
monte	монте
alonso	алонсо
lawrence	лоуренс
antoni	антоний
lamy	лами
amr	амр
zurab	зураб
hyacinthe	гиацинт
murdoch	мёрдок
vasil	васил
addison	аддисон
miron	мирон
tony	тони
markov	марков
ed	эд
stevens	стивенс
sharp	шарп
armand	арман
vega	вега
kent	кент
désiré	дезире
pacheco	пачеко
petersen	петерсен
diamond	даймонд
mancini	манчини
rustem	рустем
dion	дион
kemp	кемп
hutchinson	хатчинсон
barnett	барнетт
fleury	флёри
ursula	урсула
jansen	янсен
leroy	лерой
nielsen	нильсен
gustav	густав
bohuslav	богуслав
hamid	хамид
ernest	эрнест
polk	полк
salvadori	сальвадори
alp	алп
clements	клементс
skye	скай
hormizd	ормизд
sandy	сэнди
vahan	ваан
babcock	бэбкок
roux	ру
ashot	ашот
gedeon	гедеон
jelinek	йелинек
faustino	фаустино
mizuki	мидзуки
sutter	саттер
lieven	ливен
fiennes	файнс
ruggero	руджеро
milligan	миллиган
mickey	микки
molinari	молинари
zweig	цвейг
nándor	нандор
rade	раде
miyazawa	миядзава
böhm	бём
keiji	кэйдзи
yukari	юкари
patricio	патрисио
favre	фавр
dzintars	дзинтарс
rudenko	руденко
hyok	хёк
carles	карлес
orazio	орацио
ágnes	агнеш
fried	фрид
bender	бендер
pertti	пертти
maas	маас
monaghan	монаган
ishida	исида
arden	арден
imogen	имоджен
draper	дрейпер
honinbo	хонъимбо
beard	бирд
mi	ми
walt	уолт
litvinov	литвинов
kunio	кунио
bülent	бюлент
miura	миура
pfaff	пфафф
filatov	филатов
cosmin	космин
hitoshi	хитоси
mizuno	мидзуно
spike	спайк
duncan	дункан
rusa	руса
anaïs	анаис
ayew	айю
bodmer	бодмер
hašek	гашек
cash	кэш
hemingway	хемингуэй
holliday	холлидей
argov	аргов
pavlos	павлос
šarūnas	шарунас
salonen	салонен
toshio	тосио
hank	хэнк
wes	уэс
furukawa	фурукава
norio	норио
depardieu	депардьё
ludwik	людвик
ani	ани
patterson	паттерсон
makoto	макото
jost	йост
gonzalo	гонсало
bacon	бэкон
frith	фрит
miyamoto	миямото
eller	эллер
zina	зина
steffi	штеффи
fujisawa	фудзисава
raud	рауд
bradbury	брэдбери
menachem	менахем
léger	леже
ishii	исии
aguilera	агилера
giroux	жиру
mani	мани
henley	хенли
bettina	беттина
pla	пла
jaakko	яакко
ilkka	илкка
nakai	накаи
neher	неер
kertész	кертес
elmore	элмор
andrus	андрус
thayer	тайер
whelan	уилан
bolívar	боливар
gladys	глэдис
raj	радж
deluise	делуиз
spinks	спинкс
tomomi	томоми
marduk	мардук
kardashian	кардашян
ciprian	чиприан
živković	живкович
federica	федерика
caballero	кабальеро
leakey	лики
qing	цин
witherspoon	уизерспун
chlothar	хлотарь
messner	месснер
shirakawa	сиракава
momčilo	момчило
foreman	форман
rauno	рауно
annibale	аннибале
martti	мартти
kessel	кессель
jakobsson	якобссон
dubois	дюбуа
ramona	рамона
colby	колби
rami	рами
dunlop	данлоп
heiko	хайко
krejčí	крейчи
greco	греко
cavalieri	кавальери
hoff	хофф
candy	кэнди
merchant	мерчант
ruge	руге
kellogg	келлог
fatih	фатих
rüdiger	рюдигер
kofi	кофи
kingston	кингстон
anke	анке
araki	араки
carmelo	кармело
javanshir	джеваншир
vitale	витале
gifford	гиффорд
toivonen	тойвонен
masterson	мастерсон
böhme	бёме
degen	деген
noriega	норьега
novaković	новакович
ando	андо
rosalie	розали
callaghan	каллаган
lohan	лохан
vukašin	вукашин
erna	эрна
gilad	гилад
sexton	секстон
hendricks	хендрикс
siiri	сийри
okada	окада
ferré	ферре
viggo	вигго
knorr	кнорр
dudu	дуду
mitja	митя
barbora	барбора
satoru	сатору
jojo	джоджо
šťastný	штястный
giacometti	джакометти
sutcliffe	сатклифф
nanni	нанни
aleksić	алексич
pēteris	петерис
vojislav	воислав
lanner	ланнер
tomoko	томоко
goštautas	гаштольд
india	индия
cartier	картье
grigorescu	григореску
flowers	флауэрс
ewing	юинг
ojeda	охеда
trygve	трюгве
koldo	кольдо
cam	кэм
eumenes	эвмен
butt	батт
shimizu	симидзу
vance	вэнс
gentile	джентиле
joël	жоэль
goss	госс
leif	лейф
benita	бенита
langlois	ланглуа
colvin	колвин
mavromichalis	мавромихалис
april	эйприл
guang	гуан
sedgwick	седжвик
errol	эррол
dowd	дауд
spada	спада
johnsen	йонсен
mikel	микель
liviu	ливиу
attilio	аттилио
kendrick	кендрик
frisch	фриш
broadbent	бродбент
keaton	китон
agostini	агостини
ángeles	анхелес
duda	дуда
sastre	састре
mora	мора
juliette	жюльетта
placido	плачидо
pfeffer	пфеффер
ridley	ридли
manu	ману
arto	арто
aristarkh	аристарх
székely	секей
shriver	шрайвер
primož	примож
bodo	бодо
hiroaki	хироаки
semih	семих
arjen	арьен
manny	мэнни
vedran	ведран
deschanel	дешанель
keegan	киган
raven	рэйвен
mārtiņš	мартиньш
missy	мисси
power	пауэр
courtois	куртуа
purcell	пёрселл
yōsuke	ёсукэ
barkley	баркли
arbogast	арбогаст
hendry	хендри
rinchen	ринчен
cousins	казинс
longo	лонго
selena	селена
kazuyoshi	кадзуёси
grimaldi	гримальди
hipólito	иполито
lombard	ломбард
gerda	герда
smithson	смитсон
hastings	гастингс
teodoro	теодоро
roxana	роксана
jónsson	йоунссон
santamaría	сантамария
brahe	браге
yasushi	ясуси
logue	лог
caruso	карузо
magne	магне
zeman	земан
duchesne	дюшен
benz	бенц
ros	рос
deborah	дебора
jurica	юрица
wise	уайз
clodius	клодий
takayuki	такаюки
oren	орен
ennis	эннис
masakazu	масакадзу
liisa	лийса
emilia	эмилия
rantanen	рантанен
longuet	лонге
kaya	кая
janković	янкович
noguchi	ногути
bastos	бастос
hiller	хиллер
tata	тата
connelly	коннелли
gosling	гослинг
barrera	баррера
tipton	типтон
freund	фройнд
tsuchiya	цутия
nara	нара
doughty	даути
chloe	хлоя
ingrīda	ингрида
pavle	павле
aura	аура
tico	тику
fulvio	фульвио
rocco	рокко
val	вэл
juliet	джульет
ogata	огата
rust	руст
castelli	кастелли
zelenka	зеленка
daryl	дэрил
rankin	рэнкин
zlatan	златан
ikeda	икэда
stipe	стипе
zdzisław	здзислав
gojko	гойко
gorō	горо
burnett	бёрнетт
azevedo	азеведу
nagel	нагель
agis	агис
reinhart	рейнхарт
coelho	коэлью
zhi	чжи
michio	митио
hikaru	хикару
ilmari	илмари
răzvan	рэзван
eggert	эггерт
theodoros	теодорос
yuta	юта
briggs	бриггс
mertens	мертенс
gish	гиш
petzold	петцольд
coyle	койл
qu	цюй
nakata	наката
nakajima	накадзима
lockwood	локвуд
živko	живко
hug	хуг
cassandra	кассандра
seiji	сэйдзи
tošić	тошич
eiko	эйко
cristiano	кристиано
summer	саммер
kum	гым
brant	брант
tarō	таро
traugott	трауготт
kittel	киттель
lucrezia	лукреция
mandy	мэнди
chanel	шанель
slavko	славко
head	хэд
ringo	ринго
fumio	фумио
zuzana	зузана
mensah	менса
weise	вайзе
nobuo	нобуо
arndt	арндт
dumas	дюма
vujović	вуйович
butch	бутч
roma	рома
xavi	хави
trintignant	трентиньян
morosini	морозини
oppenheim	оппенгейм
babbitt	бэббитт
lucia	лючия
roach	роуч
aimo	аймо
clancy	клэнси
stockhausen	штокхаузен
couture	кутюр
carrière	каррьер
galla	галла
arnaldo	арнальдо
borel	борель
broderick	бродерик
masson	массон
asano	асано
yujiulü	юйцзюлюй
indra	индра
sławomir	славомир
shintaro	синтаро
atsushi	ацуси
keisha	кейша
shimada	симада
hrvoje	хрвое
stevanović	стеванович
lorne	лорн
oates	оутс
brasseur	брассёр
freud	фрейд
dell	делл
mäkinen	мякинен
gaon	гаон
uzi	узи
ferruccio	ферруччо
tuomas	туомас
waltz	вальц
janez	янез
drago	драго
pere	пере
lekapenos	лакапин
ganz	ганц
hobart	хобарт
pettersson	петтерссон
lessing	лессинг
prisca	приска
garibaldi	гарибальди
risto	ристо
todorović	тодорович
nakahara	накахара
sauer	зауэр
gaspare	гаспаре
naim	наим
cvetković	цветкович
hashimoto	хасимото
dlamini	дламини
ochoa	очоа
ezra	эзра
waller	уоллер
jasper	джаспер
edson	эдсон
ristić	ристич
philaret	филарет
michaels	майклз
gaël	гаэль
scarlatti	скарлатти
tadashi	тадаси
krišjānis	кришьянис
eiji	эйдзи
house	хаус
dvořák	дворжак
joris	йорис
gamarra	гамарра
jurić	юрич
potts	поттс
kretschmer	кречмер
yossi	йоси
hosokawa	хосокава
negri	негри
lillian	лиллиан
nani	нани
peković	пекович
irons	айронс
orhan	орхан
butterfield	баттерфилд
urmas	урмас
brentano	брентано
sørensen	сёренсен
whitfield	уитфилд
abigail	эбигейл
dries	дрис
tōru	тору
ichirō	итиро
mcfadden	макфадден
lazarević	лазаревич
vela	вела
marchetti	маркетти
poll	полл
wallin	валлин
ames	эймс
knežević	кнежевич
tomita	томита
cartwright	картрайт
hideaki	хидэаки
riera	риера
graziani	грациани
oktay	октай
carré	карре
davy	дэви
dobson	добсон
nodar	нодар
easton	истон
cha	чха
babić	бабич
yoshimoto	ёсимото
betts	беттс
mitra	митра
yoshiaki	ёсиаки
lakshmi	лакшми
contreras	контрерас
kateřina	катержина
solon	солон
kiyoshi	киёси
renzo	ренцо
marika	марика
kalle	калле
menno	менно
segundo	сегундо
parnell	парнелл
turnbull	тернбулл
donnie	донни
emmett	эмметт
sabatier	сабатье
teuvo	теуво
cave	кейв
pavlovich	павлович
irina	ирина
mikhail	михаил
arkady	аркадий
tolstoy	толстой
estrada	эстрада
francisco	франсиско
veli	вели
bolesław	болеслав
colonna	колонна
fidel	фидель
hamilton	гамильтон
shalva	шалва
severus	север
johnston	джонстон
vytautas	витаутас
michael	майкл
jaime	хайме
kaplan	каплан
fitzgerald	фицджеральд
cummings	каммингс
cabral	кабрал
frolov	фролов
nikephoros	никифор
fyodor	фёдор
theo	тео
miriam	мириам
alik	алик
fowler	фаулер
fuentes	фуэнтес
cecilia	сесилия
beth	бет
adhemar	адемар
carloman	карломан
gusev	гусев
astrid	астрид
jesús	хесус
novikov	новиков
mills	миллс
solomon	соломон
nadezhda	надежда
núñez	нуньес
welch	уэлч
gheorghe	георге
gonzaga	гонзага
angie	энджи
borisovich	борисович
chapman	чепмен
reza	реза
bowie	боуи
justo	хусто
shirazi	ширази
petr	петр
blanche	бланш
camargo	камарго
anastasius	анастасий
vasily	василий
willard	уиллард
georgios	георгиос
lyon	лайон
bernstein	бернштейн
nuri	нури
job	иов
mariam	мариам
roberta	роберта
kershaw	кершоу
padilla	падилья
jiménez	хименес
idris	идрис
yusuf	юсуф
kate	кейт
johansson	юханссон
uri	ури
denisov	денисов
irakli	ираклий
musa	муса
holman	холман
ibragimov	ибрагимов
ha	ха
toussaint	туссен
könig	кёниг
xiao	сяо
tudhaliya	тудхалия
jacobi	якоби
ari	ари
ignaz	игнац
lacroix	лакруа
michel	мишель
mori	мори
albrecht	альбрехт
henriette	генриетта
sultan	султан
stepanov	степанов
ignacy	игнацы
janssen	янссен
heller	хеллер
evelyn	эвелин
heather	хизер
may	мэй
horn	хорн
adalbert	адальберт
arias	ариас
elmar	эльмар
clemente	клементе
eudokia	евдокия
cassini	кассини
boyce	бойс
winston	уинстон
mortimer	мортимер
petras	пятрас
dumitru	думитру
moss	мосс
bret	брет
brunner	бруннер
palacio	паласио
poulsen	поульсен
piper	пайпер
gross	гросс
berenice	береника
fernand	фернан
escobar	эскобар
petit	пети
aitken	эйткен
chávez	чавес
ilyas	ильяс
canning	каннинг
lerner	лернер
sheikh	шейх
kirill	кирилл
lebedev	лебедев
herrera	эррера
pius	пий
stefania	стефания
cécile	сесиль
flores	флорес
rogers	роджерс
madeleine	мадлен
osborne	осборн
anwar	анвар
lima	лима
étienne	этьен
adolf	адольф
szabó	сабо
pizarro	писарро
guerra	герра
hernando	эрнандо
myron	майрон
bermúdez	бермудес
colbert	кольбер
nicholson	николсон
gage	гейдж
galeazzo	галеаццо
herschel	гершель
savary	савари
hale	хейл
orsini	орсини
schuster	шустер
yue	юэ
aram	арам
galen	гален
campo	кампо
zhukov	жуков
scholz	шольц
lear	лир
mireille	мирей
moody	муди
boone	бун
steffen	штеффен
tshering	церинг
golden	голден
gallo	галло
stevenson	стивенсон
riedel	ридель
marchand	маршан
mina	мина
cortés	кортес
bieler	билер
merrill	меррилл
alvarado	альварадо
damjan	дамьян
villanueva	вильянуэва
kurz	курц
michalis	михалис
galindo	галиндо
palermo	палермо
vincas	винцас
grenier	гренье
probus	проб
palm	пальм
cosimo	козимо
participazio	партечипацио
mclean	маклин
lavinia	лавиния
eileen	айлин
carmichael	кармайкл
howell	хауэлл
ernie	эрни
manius	маний
kraus	краус
ouédraogo	уэдраого
giorgio	джорджо
saavedra	сааведра
sandoval	сандоваль
prévost	прево
woodward	вудворд
margareta	маргарета
maitland	мейтленд
roemer	рёмер
hooker	хукер
harlan	харлан
guadalupe	гуадалупе
yoav	йоав
amado	амадо
nate	нейт
ehud	эхуд
cabañas	кабаньяс
deville	девиль
madden	мэдден
pavlov	павлов
knight	найт
buchanan	бьюкенен
bertha	берта
jakub	якуб
ilyich	ильич
epstein	эпштейн
judith	джудит
bogdan	богдан
brian	брайан
nora	нора
julius	юлиус
prosper	проспер
horace	хорас
andranik	андраник
kitty	китти
adil	адиль
yakovlev	яковлев
jurgis	юргис
chandra	чандра
kress	кресс
sigmund	зигмунд
damir	дамир
rufinus	руфин
gatti	гатти
desai	десаи
maidana	майдана
young	янг
schilling	шиллинг
shevchenko	шевченко
diogenes	диоген
lau	лау
sinan	синан
joubert	жубер
linares	линарес
bruni	бруни
jahangir	джахангир
plamen	пламен
dimitris	димитрис
akiva	акива
constantius	констанций
sorokin	сорокин
wen	вэнь
ingvar	ингвар
downing	даунинг
hurley	хёрли
greenfield	гринфилд
shamil	шамиль
soraya	сорайя
hardin	хардин
zaza	заза
atanas	атанас
garnett	гарнетт
scherer	шерер
liv	лив
dean	дин
ashur	ашшур
susan	сьюзан
petty	петти
rostislav	ростислав
pedro	педро
sergio	серхио
casey	кейси
irwin	ирвин
barton	бартон
yves	ив
meyer	мейер
alf	альф
naftali	нафтали
day	дэй
tikhonov	тихонов
angela	анджела
shapiro	шапиро
komarov	комаров
ernő	эрнё
octavius	октавиус
gabriele	габриэле
abramov	абрамов
heywood	хейвуд
parry	пэрри
atkins	аткинс
strutt	стратт
davison	дэвисон
eisner	айснер
january	дженьюари
procopius	прокопий
pfeiffer	пфайффер
dmitriev	дмитриев
ignatyev	игнатьев
makarov	макаров
spartacus	спартак
sheen	шин
bilal	билал
bloch	блох
torsten	торстен
agapetus	поучение
ödön	эдён
nam	нам
daniela	даниэла
calvert	калверт
reis	реис
vivien	вивьен
igor	игорь
neville	невилл
castro	кастро
fraser	фрейзер
théophile	теофиль
priscilla	присцилла
joan	джоан
dietrich	дитрих
anicius	аниций
amaral	амарал
hurtado	уртадо
el	эль
barr	барр
crowe	кроу
richmond	ричмонд
wilfried	вильфрид
stepanovich	степанович
rojas	рохас
ralph	ральф
nahum	нахум
levin	левин
steele	стил
alexander	александр
maria	мария
louise	луиза
matthias	маттиас
norberg	норберг
wong	вонг
sagan	саган
menotti	менотти
lupu	лупу
olybrius	олибрий
dagobert	дагоберт
estévez	эстевес
filipe	филипе
ogden	огден
aston	астон
kalinowski	калиновский
rada	рада
vesna	весна
cassel	кассель
klinger	клингер
peeter	пеэтер
bastien	бастьен
giuliani	джулиани
montoya	монтойя
batyr	батыр
oliva	олива
socrates	сократ
langley	лэнгли
bogdanov	богданов
zelda	зельда
chow	чоу
giacinto	джачинто
isser	иссер
chadwick	чедвик
petros	петрос
hough	хаф
maguire	магуайр
manfredini	манфредини
dionisio	дионисио
mcnamara	макнамара
majid	маджид
irma	ирма
coolidge	кулидж
fillmore	филлмор
rivero	риверо
faure	фор
diehl	диль
osgood	осгуд
uribe	урибе
grete	грете
abt	абт
dole	доул
octavio	октавио
drexler	дрекслер
priit	прийт
baldassare	бальдассаре
isaiah	исаия
marsha	марша
papa	папа
capone	капоне
sabri	сабри
kilian	килиан
dávila	давила
kamo	камо
getty	гетти
matthäus	маттеус
larkin	ларкин
mcgee	макги
rzewuski	ржевуский
rusticus	рустик
grassi	грасси
marcian	маркиан
lü	люй
hatcher	хэтчер
ríos	риос
renan	ренан
olin	олин
guinness	гиннесс
elon	элон
bas	бас
scholasticus	схоластик
korir	корир
godard	годар
järnefelt	ярнефельт
evander	эвандер
thatcher	тэтчер
badri	бадри
wieland	виланд
veselin	веселин
alberta	альберта
oviedo	овьедо
violeta	виолета
ten	тен
imelda	имельда
modibo	модибо
aarne	аарне
tissot	тиссо
rune	руне
koman	коман
iva	ива
hübner	хюбнер
swan	суон
popper	поппер
auer	ауэр
french	френч
nova	нова
mahler	малер
windsor	виндзор
leach	лич
yin	инь
lilienthal	лилиенталь
abadie	абади
ibáñez	ибаньес
rabah	рабах
farrar	фаррар
ehrenfried	эренфрид
colton	колтон
cort	корт
virginie	виржини
arp	арп
raffi	раффи
barrios	барриос
laroche	ларош
cai	цай
otero	отеро
abrahams	абрахамс
bona	бона
kuroda	курода
niyazi	ниязи
aaltonen	аалтонен
childebert	хильдеберт
neruda	неруда
dun	дунь
sherwin	шервин
ebert	эберт
carmack	кармак
thor	тор
schwab	шваб
kaczmarek	качмарек
vladas	владас
vida	вида
amenhotep	аменхотеп
postumus	постум
quesada	кесада
ivanova	иванова
case	дело
milutin	милутин
eggen	эгген
horatio	горацио
lovett	ловетт
sims	симс
blanc	блан
leszek	лешек
tõnu	тыну
parr	парр
ubaldo	убальдо
fodor	фодор
horner	хорнер
wills	уиллс
rosenbaum	розенбаум
rojo	рохо
sherwood	шервуд
diviš	дивиш
proust	пруст
fra	фра
aho	ахо
báthory	батори
barbu	барбу
harlow	харлоу
ansari	ансари
charpentier	шарпантье
boileau	буало
constant	констан
keith	кит
alec	алек
fournier	фурнье
albert	альберт
michele	микеле
abdul	абдул
kravchenko	кравченко
bashir	башир
vardan	вардан
fedotov	федотов
borisov	борисов
leonov	леонов
julio	хулио
cassius	кассий
kirk	кирк
renata	рената
bernhard	бернхард
edward	эдвард
pons	понс
yuri	юрий
vladimirovich	владимирович
jacopo	якопо
emin	эмин
castillo	кастильо
walid	валид
marie	мари
moura	моура
lenoir	ленуар
prescott	прескотт
camara	камара
witte	витте
man	ман
engel	энгель
giraud	жиро
watt	уотт
stasys	стасис
bragg	брэгг
solís	солис
engelbert	энгельберт
horowitz	горовиц
polly	полли
cameron	кэмерон
rubens	рубенс
noble	нобл
durand	дюран
maureen	морин
shinya	синъя
panin	панин
dalton	далтон
romeo	ромео
molla	молла
berkeley	беркли
agrippa	агриппа
benedict	бенедикт
davidovich	давидович
semyonovich	семёнович
xavier	ксавье
struve	струве
hermann	герман
josé	хосе
gottfried	готфрид
lefebvre	лефевр
aurelius	аврелий
magdalena	магдалена
gaston	гастон
archibald	арчибальд
enrique	энрике
rogvolod	рогволод
carracci	карраччи
lučić	лучич
spector	спектор
kawakami	каваками
vagnozzi	ваньоцци
bettencourt	беттанкур
arend	аренд
abril	абриль
aristotle	аристотель
brenner	бреннер
aigner	айгнер
marwan	марван
banana	банана
katsura	кацура
dreher	дреер
lira	лира
movilă	могила
kuijken	кёйкен
staal	стаал
janda	янда
eilhard	эйльхард
félicien	фелисьен
auld	олд
andretti	андретти
ōkubo	окубо
neuner	нойнер
morimoto	моримото
saura	саура
ales	алесь
yumiko	юмико
parrish	пэрриш
susie	сьюзи
juninho	жуниньо
zeitlin	цейтлин
misaki	мисаки
gradenigo	градениго
hollander	холландер
euclid	евклид
oz	оз
asia	азия
mcnab	макнаб
ōtani	отани
dacier	дасье
fleet	флит
filho	фильо
parseval	парсеваль
arnuwanda	арнуванда
shuttarna	шуттарна
glenda	гленда
whiteley	уайтли
hager	хагер
hozumi	ходзуми
bardem	бардем
vyšniauskas	вишняускас
quiroga	кирога
probst	пробст
yeghishe	егише
drury	друри
hirsch	хирш
frobenius	фробениус
kanu	кану
fairuz	файруз
kovalenko	коваленко
porras	поррас
crompton	кромптон
kurihara	курихара
masayoshi	масаёси
ina	ина
dakota	дакота
miyuki	миюки
cloquet	клоке
reidar	рейдар
linna	линна
hasse	хассе
kling	клинг
rudd	радд
firuz	фируз
yagan	яган
jellinek	еллинек
akamatsu	акамацу
gebauer	гебауэр
seamus	шеймас
kolbe	кольбе
yuriko	юрико
zakharov	захаров
spitzer	спитцер
harnack	харнак
stefanović	стефанович
goodman	гудмен
cage	кейдж
kawaguchi	кавагути
arafat	арафат
arcangelo	арканджело
bellucci	беллуччи
vanek	ванек
bassano	бассано
conchita	кончита
tõnis	тынис
takagi	такаги
keri	кери
simrock	зимрок
bodil	бодил
bugatti	бугатти
kazuhiko	кадзухико
germano	джермано
byrnes	бирнс
guaita	гуайта
wouter	ваутер
matić	матич
agnès	аньес
mukai	мукаи
annabella	аннабелла
nozawa	нодзава
kerwin	кервин
goode	гуд
nobuyuki	нобуюки
iurie	юрие
baptista	баптиста
ridgway	риджуэй
cleombrotus	клеомброт
gaddi	гадди
paisley	пейсли
simonsen	симонсен
zhiyi	чжии
anquetil	анкетиль
mounier	мунье
manolis	манолис
aizawa	айдзава
lanza	ланца
tomi	томи
knapp	кнапп
piccolomini	пикколомини
hansson	ханссон
masuda	масуда
quietus	квиет
crvenkovski	црвенковский
sanada	санада
otar	отар
haines	хейнс
ponti	понти
sturges	стёрджес
downs	даунс
vanja	ваня
hewlett	хьюлетт
felicity	фелисити
myrdal	мюрдаль
ghirlandaio	гирландайо
kipruto	кипруто
haruka	харука
taddeo	таддео
gérald	жеральд
jascha	яша
strait	стрейт
shepherd	шеперд
lautaro	лаутаро
masters	мастерс
simion	симион
takuya	такуя
soria	сория
sadat	садат
rommel	роммель
aumont	омон
mateja	матея
shimura	симура
kiprop	кипроп
grünberg	грюнберг
akinori	акинори
morgenstern	моргенштерн
pichler	пихлер
delfino	дельфино
jimi	джими
shamir	шамир
alden	олден
mcguinness	макгиннесс
crispus	крисп
marlies	марлис
tiepolo	тьеполо
vinnie	винни
cassirer	кассирер
small	смолл
clijsters	клейстерс
boateng	боатенг
trinidad	тринидад
frederico	фредерико
stojanović	стоянович
konarski	конарский
jewel	джуэл
rabbani	раббани
mcshane	макшейн
drews	древс
kimmo	киммо
sergiu	серджиу
zárate	сарате
sela	села
ka	ка
porat	порат
järvi	ярви
winkelhock	винкельхок
cowen	коуэн
harada	харада
braulio	браулио
hobson	гобсон
lysander	лисандр
stenbock	стенбок
miran	миран
madoka	мадока
faliero	фальер
britten	бриттен
calder	колдер
aurélien	орельен
palladino	палладино
amadeo	амадео
gerhardt	герхардт
ramiro	рамиро
hari	хари
casati	казати
raimi	рэйми
kiyotaka	киётака
silvestri	сильвестри
dunham	данэм
bunny	банни
imai	имаи
rincón	ринкон
hikmet	хикмет
bancroft	бэнкрофт
ionuţ	йонуц
pegg	пегг
roché	роше
tempesta	темпеста
markku	маркку
seton	сетон
alessi	алесси
izumi	идзуми
ayumi	аюми
gallas	галлас
blount	блаунт
duplessis	дюплесси
schenker	шенкер
syme	сайм
numa	нюма
link	линк
milutinović	милутинович
baines	бейнс
giampiero	джампьеро
yoshiko	ёсико
mclaughlin	маклафлин
holbrook	холбрук
ren	жэнь
mayfield	мэйфилд
ilze	илзе
childs	чайлдс
nie	не
haddad	хаддад
bertoni	бертони
butcher	бутчер
iveta	ивета
nena	нена
kallio	каллио
radovan	радован
mäkelä	мякеля
mcauliffe	маколифф
nissen	ниссен
sabatini	сабатини
kyoko	кёко
joseba	хосеба
eckhart	экхарт
weinstein	вайнштейн
konishi	кониси
takamura	такамура
keil	кейль
wilmot	уилмот
meister	майстер
iwasaki	ивасаки
spurius	спурий
stoner	стоунер
vulpius	вульпиус
solano	солано
hassler	хасслер
tequila	текила
rodrigue	родриг
london	лондон
kassim	кассим
delbrück	дельбрюк
samaras	самарас
kidman	кидман
tournier	турнье
bruckner	брукнер
danner	даннер
nurmi	нурми
buffet	бюффе
marconi	маркони
boleyn	болейн
seigner	сенье
begović	бегович
pitts	питтс
navarrete	наваррете
lagarde	лагард
charilaos	харилаос
niebuhr	нибур
somers	сомерс
solbakken	сольбаккен
mcgill	макгилл
munari	мунари
nachman	нахман
bossi	босси
hoang	хоанг
guðmundsson	гудмундссон
aurelian	аврелиан
condon	кондон
diodotus	диодот
becher	бехер
reber	ребер
lanfranc	ланфранк
pejačević	пеячевич
eri	эри
iancu	янку
aida	айда
lundberg	лундберг
psamtik	псамметих
gerlach	герлах
kōtoku	котоку
norwood	норвуд
elst	эльст
lolo	лоло
horie	хориэ
till	тилл
crivelli	кривелли
hartmut	хартмут
pocock	покок
dorival	доривал
popescu	попеску
bronson	бронсон
katona	катона
romberg	ромберг
yakubu	якубу
baumbach	баумбах
lavin	лавин
celio	челио
roddy	родди
chadli	шадли
sandford	сэндфорд
ranieri	раньери
qureshi	куреши
foy	фой
arius	арий
sinatra	синатра
priestley	пристли
takács	такач
barbieri	барбьери
bjørndalen	бьёрндален
arveladze	арвеладзе
franka	франка
jarno	ярно
lamine	ламин
rukavina	рукавина
hai	хай
huey	хьюи
callinicus	каллиник
marita	марита
lindahl	линдаль
criss	крисс
piłsudski	пилсудский
bartolucci	бартолуччи
yuzo	юдзо
vitas	витас
bedřich	бедржих
hoyt	хойт
brewster	брюстер
steinbach	штайнбах
timothée	тимоте
angerer	ангерер
trey	трей
weigel	вайгель
morrissey	моррисси
daniella	даниэлла
nadal	надаль
zima	зима
noriyuki	нориюки
rezső	режё
kocsis	кочиш
statius	стаций
eliseo	элисео
botha	бота
nef	неф
obregón	обрегон
eurico	эурику
ramūnas	рамунас
uno	уно
luque	луке
jokinen	йокинен
corneille	корнель
nehemiah	неемия
olavi	олави
bessie	бесси
heitor	эйтор
kamiya	камия
vitti	витти
susana	сусана
thorvald	торвальд
sala	сала
popa	попа
stiller	стиллер
hauptmann	гауптман
button	баттон
olsson	ульссон
chet	чет
lindberg	линдберг
hamm	хэмм
skarsgård	скарсгорд
wojtek	войтек
reagan	рейган
strickland	стрикленд
petráš	петраш
krunoslav	крунослав
sakurai	сакураи
dujardin	дюжарден
szabados	сабадош
huisheng	хуэйшэн
crossley	кроссли
benjamín	бенхамин
feliciano	фелисиано
shuja	шуджа
olympia	олимпия
otter	оттер
stavros	ставрос
győző	дьёзё
staunton	стонтон
kvaternik	кватерник
liebert	либерт
selma	сельма
antje	антье
schnabel	шнабель
priest	прист
corelli	корелли
fanning	фэннинг
syagrius	сиагрий
maleeva	малеева
valverde	вальверде
kamiński	каминьский
laurus	лавр
mok	мок
naguib	нагиб
hitchcock	хичкок
ferro	ферро
albertini	альбертини
kaoru	каору
aubin	обен
kinski	кински
mcdonnell	макдоннелл
jyrki	юрки
goodall	гудолл
krag	краг
brzozowski	бжозовский
atahualpa	атауальпа
kamm	камм
skyler	скайлер
humphries	хамфрис
matsuoka	мацуока
lysias	лисий
thorpe	торп
taku	таку
kibet	кибет
isidoro	исидоро
damo	дамо
trujillo	трухильо
kazuyuki	кадзуюки
garson	гарсон
mura	мура
régine	режин
blasco	бласко
fermín	фермин
blythe	блайт
banda	банда
gardel	гардель
calvus	кальв
yumi	юми
shang	шан
vittoria	виттория
kühn	кюн
coleridge	кольридж
avram	аврам
savannah	саванна
everton	эвертон
eliud	элиуд
vesa	веса
letícia	летисия
donato	донато
dirceu	дирсеу
massa	масса
gresley	грисли
mineiro	минейро
conon	конон
kazuya	кадзуя
heiberg	хейберг
avril	авриль
bento	бенту
grimshaw	гримшоу
reg	рег
ceaușescu	чаушеску
uschi	уши
stepney	степни
vic	вик
zsigmond	жигмонд
avendaño	авенданьо
dupont	дюпон
hino	хино
crook	крук
franchi	франки
hobbs	хоббс
erling	эрлинг
neumeier	ноймайер
dumoulin	дюмулен
ferretti	ферретти
taner	танер
arad	арад
devlin	девлин
darin	дарин
belinda	белинда
solveig	сольвейг
albani	альбани
asakura	асакура
rubini	рубини
moll	молль
lederer	ледерер
wyeth	уайет
forsberg	форсберг
lenny	ленни
blake	блейк
tamura	тамура
issei	иссэй
dao	дао
rossiter	росситер
esquivel	эскивель
kašpar	кашпар
csaba	чаба
hélder	элдер
yegor	егор
chance	ченс
hearn	хирн
lund	лунд
taglioni	тальони
karimi	карими
yazid	язид
carnahan	карнахан
narayan	нараян
sena	сена
žydrūnas	жидрунас
arvidsson	арвидссон
kirkpatrick	киркпатрик
aeschines	эсхин
leonel	леонель
amit	амит
rossellini	росселлини
rockefeller	рокфеллер
ozols	озолс
vítězslav	витезслав
swain	суэйн
morse	морс
didi	диди
yasuda	ясуда
berliner	берлинер
upton	аптон
apion	апион
ledger	леджер
damjanović	дамьянович
sacher	захер
horrocks	хоррокс
karppinen	карппинен
borchert	борхерт
liebknecht	либкнехт
terje	терье
bayezid	баязид
kohl	коль
vlada	влада
yokoyama	ёкояма
canales	каналес
milić	милич
shishkin	шишкин
bischoff	бишофф
ronconi	ронкони
carstens	карстенс
hellman	хеллман
brun	брун
immanuel	иммануил
bono	боно
friel	фрил
culkin	калкин
nordahl	нурдаль
perrault	перро
staudinger	штаудингер
rollin	роллен
pirro	пирро
ducke	дукке
linas	линас
croce	кроче
plaskett	пласкетт
kiki	кики
nada	нада
cotta	котта
paulson	полсон
soler	солер
short	шорт
tyszkiewicz	тышкевич
partridge	партридж
baird	бэрд
aramburu	арамбуру
kubrat	кубрат
walpole	уолпол
ottmar	оттмар
wiesław	веслав
winfried	винфрид
ueshiba	уэсиба
simonetta	симонетта
villon	вийон
chūichi	тюити
doni	дони
simović	симович
sarduri	сардури
đilas	джилас
simić	симич
six	сикс
toshiki	тосики
lustig	лустиг
chopra	чопра
fehr	фер
jie	цзе
shirō	сиро
ježek	ежек
moschus	мосх
zou	цзоу
jelić	елич
gamal	гамаль
metaxas	метаксас
joss	джосс
thiele	тиле
sugimoto	сугимото
bibiana	бибиана
kabir	кабир
weller	уэллер
ivković	ивкович
marcius	марций
leto	лето
schenck	шенк
lei	лэй
takada	такада
ousmane	усман
grandjean	гранжан
ozawa	одзава
hamel	хэмел
salgado	сальгадо
marton	мартон
doc	док
clough	клаф
domingos	домингуш
štěpán	штепан
jarry	жарри
kantakouzenos	кантакузин
kenyon	кеньон
harker	харкер
michela	микела
ranavalona	ранавалуна
agag	агаг
ronaldo	роналдо
frane	фране
dimas	димас
allende	альенде
gaynor	гейнор
lippo	липпо
dermot	дермот
noriaki	нориаки
burian	буриан
ladd	лэдд
mariko	марико
rueda	руэда
amati	амати
štimac	штимац
tillman	тиллман
delta	дельта
eliot	элиот
uematsu	уэмацу
mcgovern	макговерн
blume	блюме
storm	сторм
cuauhtémoc	куаутемок
okan	окан
malmström	мальмстрём
scola	скола
djalma	джалма
marceau	марсо
anémone	анемон
marquard	марквард
norodom	нородом
bartram	бартрам
farnese	фарнезе
holloway	холлоуэй
schober	шобер
dimitrie	димитрие
mendelssohn	мендельсон
pender	пендер
valentinian	валентиниан
gade	гаде
higgs	хиггс
callum	каллум
rurik	рюрик
schröder	шрёдер
funakoshi	фунакоси
arantxa	аранча
shahi	шахи
dado	дадо
łukasiewicz	лукасевич
biagio	бьяджо
seeger	сигер
romeu	ромеу
colm	колм
boss	босс
ennio	эннио
peled	пелед
mátyás	матьяш
zaimis	заимис
mago	магон
duchamp	дюшан
patsy	пэтси
ionel	йонел
ives	айвз
bernat	бернат
locatelli	локателли
krupa	крупа
károlyi	каройи
klimov	климов
victoriano	викториано
vlatko	влатко
munk	мунк
brolin	бролин
posey	поузи
fine	файн
parviz	парвиз
carrington	каррингтон
buch	бух
dąbrowski	домбровский
cissé	сиссе
netanyahu	нетаньяху
uchida	утида
mitsuko	мицуко
doyle	дойл
mifsud	мифсуд
covey	кови
to	то
efron	эфрон
lasker	ласкер
lahti	лахти
lobos	лобос
groza	гроза
carducci	кардуччи
žarko	жарко
barone	бароне
guthrie	гатри
kumi	куми
lvovich	львович
blix	бликс
ocean	оушен
büchner	бюхнер
lyman	лайман
soule	соул
lucky	лаки
isao	исао
prestes	престес
kodaira	кодайра
bosson	боссон
leko	леко
rigoberto	ригоберто
hiramatsu	хирамацу
pozo	посо
sikorski	сикорский
mcguire	макгуайр
pennant	пеннант
cass	касс
zanetti	дзанетти
radić	радич
takemiya	такэмия
gordian	гордиан
pape	пап
payton	пэйтон
chu	чу
maduro	мадуро
cusack	кьюсак
melina	мелина
masami	масами
flower	флауэр
klose	клозе
intef	иниотеф
minkowski	минковский
hermione	гермиона
claudel	клодель
strasser	штрассер
travers	трэверс
grimes	граймс
linz	линц
catalina	каталина
toller	толлер
samson	самсон
marović	марович
chieko	тиэко
noriko	норико
aigars	айгар
bianco	бьянко
masaaki	масааки
satomi	сатоми
mirjana	мирьяна
branković	бранкович
haley	хейли
michaelis	михаэлис
quilico	килико
wheeler	уилер
way	уэй
tello	тельо
vujadin	вуядин
lemm	лемм
mead	мид
kaori	каори
dursun	дурсун
firlej	фирлей
andoni	андони
behrens	беренс
browder	браудер
curci	курчи
arnošt	арношт
krukenberg	крукенберг
cañete	каньете
weeks	уикс
kienzl	кинцль
tola	тола
felton	фелтон
cavalli	кавалли
nomura	номура
lippi	липпи
baer	бэр
akio	акио
corbett	корбетт
caron	карон
vukčević	вукчевич
tivadar	тивадар
beverly	беверли
anssi	ансси
khoja	ходжа
silvano	сильвано
sulzer	зульцер
erkin	эркин
harrell	харрелл
lassila	лассила
koné	коне
ander	андер
billington	биллингтон
itzik	ицик
rafik	рафик
menander	менандр
guimard	гимар
finney	финни
kōki	коки
koivu	койву
ilić	илич
clooney	клуни
byrne	бирн
odilon	одилон
styles	стайлс
dvorak	дворак
brühl	брюль
chandragupta	чандрагупта
oberto	оберто
masamune	масамунэ
becerra	бесерра
király	кирай
mitsuru	мицуру
lakatos	лакатош
malatesta	малатеста
leno	лено
rabe	рабе
tasso	тассо
jenner	дженнер
melody	мелоди
nishizawa	нисидзава
barragán	барраган
barbarigo	барбариго
antisthenes	антисфен
georgina	джорджина
daiki	дайки
coulibaly	кулибали
baggio	баджо
childeric	хильдерик
bianca	бьянка
nesbit	несбит
osorio	осорио
arditi	ардити
penna	пенна
shusaku	сюсаку
farr	фарр
nobuko	нобуко
horia	хория
searle	сирл
alpha	альфа
kawasaki	кавасаки
lagos	лагос
senna	сенна
ebbe	эббе
sangay	сангай
mcconnell	макконнелл
annemarie	аннемари
assmann	ассман
gershon	гершон
hardwicke	хардвик
béjart	бежар
voisin	вуазен
stanko	станко
sander	сандер
uemura	уэмура
sheng	шэн
aino	айно
jameson	джеймсон
molitor	молитор
koller	коллер
huff	хафф
beckett	беккет
rolin	ролен
stout	стаут
sigebert	сигиберт
pernilla	пернилла
lerman	лерман
wilding	уайлдинг
paulette	полетт
sauli	саули
huss	хусс
ainārs	айнарс
majewski	маевский
neco	неко
karlheinz	карлхайнц
hatch	хэтч
serafino	серафино
royce	ройс
kubilius	кубилюс
yoshinori	ёсинори
astley	эстли
folke	фольке
mccloskey	макклоски
wunderlich	вундерлих
am	ам
coppi	коппи
ljubičić	любичич
garth	гарт
koichi	коити
apostolos	апостолос
khamis	хамис
herzl	герцель
schleck	шлек
robb	робб
kana	кана
hinds	хайндс
masato	масато
patel	патель
ke	кэ
kenzo	кэндзо
elissa	элисса
simson	симсон
rogge	рогге
ness	несс
gunnarsson	гуннарссон
sonam	сонам
ljubiša	любиша
makhmalbaf	махмальбаф
palacios	паласиос
victorio	викторио
vlasta	власта
mutō	муто
shōhei	сёхэй
thévenot	тевено
danna	данна
mauno	мауно
cápac	капак
manco	манко
keeler	килер
nguema	нгема
amorim	аморим
slavin	славин
kawai	каваи
edin	эдин
abdelkader	абделькадер
hildebrand	гильдебранд
deon	деон
tadić	тадич
rēdlihs	редлихс
botero	ботеро
fats	фэтс
yeboah	йебоа
yasuo	ясуо
munir	мунир
pascual	паскуаль
shoko	сёко
gérson	жерсон
filipović	филипович
kadlec	кадлец
henkel	хенкель
masahiko	масахико
heng	хэн
warburton	уорбертон
mikkel	миккель
spottiswoode	споттисвуд
anđelković	анджелкович
mayumi	маюми
saba	саба
shawcross	шоукросс
montero	монтеро
kepler	кеплер
pellegrini	пеллегрини
morrill	моррилл
bernabé	бернабе
amalric	амальрик
winslow	уинслоу
leckie	леки
arūnas	арунас
beretta	беретта
poppy	поппи
ronson	ронсон
bjarne	бьярне
dezső	дежё
shō	сё
albers	альберс
corr	корр
carrillo	каррильо
indravarman	индраварман
sali	сали
eloy	элой
senusret	сенусерт
bushnell	бушнелл
qutb	кутб
burney	бёрни
babangida	бабангида
ange	анж
truong	чыонг
golan	голан
ćosić	чосич
tweed	твид
borg	борг
koyama	кояма
joakim	йоаким
tocco	токко
schott	шотт
adad	адад
indrek	индрек
niklaus	никлаус
corradini	коррадини
laila	лайла
gamboa	гамбоа
prada	прада
ball	болл
jupp	юпп
flesch	флеш
stevie	стиви
mirsad	мирсад
ratko	ратко
mursili	мурсили
chiesa	кьеза
chopin	шопен
hamed	хамед
suat	суат
tarver	тарвер
blaž	блаж
smedley	смедли
edgeworth	эджуорт
vivarini	виварини
veljko	велько
addo	аддо
burhan	бурхан
menzies	мензис
karp	карп
jian	цзянь
jacquet	жаке
yazdegerd	йездигерд
tonino	тонино
stowe	стоу
madge	мэдж
sutermeister	зутермайстер
andreae	андреэ
sampson	сэмпсон
berit	берит
mattei	маттеи
grandi	гранди
saki	саки
jans	янс
dutt	датт
baresi	барези
yoshiharu	ёсихару
schwimmer	швиммер
ponce	понсе
agus	агус
micha	миха
antić	антич
fabricio	фабрисио
winters	уинтерс
bekele	бекеле
kalla	калла
coltrane	колтрейн
muldoon	малдун
rao	рао
bílek	билек
knauer	кнауер
nansen	нансен
smendes	смендес
arlt	арльт
refik	рефик
lindström	линдстрём
valtonen	валтонен
conradin	конрадин
rivlin	ривлин
kiefer	кифер
ciro	чиро
marla	марла
volker	фолькер
pipes	пайпс
santer	сантер
frick	фрик
tecumseh	текумсе
rolandas	роландас
bérénice	беренис
pickford	пикфорд
amel	амель
sjöberg	шёберг
eliasson	элиассон
dung	зунг
asamoah	асамоа
toomas	тоомас
goßler	госслер
bolaños	боланьос
gallardo	гальярдо
armani	армани
leite	лейте
hanke	ханке
boni	бони
ulrik	ульрик
angulo	ангуло
milev	милев
judas	иуда
koskinen	коскинен
nyman	нюман
baum	баум
tomaž	томаж
kunihiko	кунихико
arrigo	арриго
ildefons	ильдефонс
farah	фарах
koloman	коломан
artis	артис
mészáros	месарош
álvares	альвареш
bonnet	бонне
povilas	повилас
tierney	тирни
perović	перович
amritraj	амритрадж
jonker	йонкер
arron	аррон
mahal	махал
hirano	хирано
naoko	наоко
takeuchi	такэути
gustave	гюстав
raskin	раскин
furtado	фуртадо
kōichirō	коитиро
collison	коллисон
ohara	охара
mohsen	мохсен
birch	бёрч
shuai	шуай
manos	манос
yitzhak	ицхак
pepe	пепе
hakan	хакан
raimondi	раймонди
tessa	тесса
esau	исав
cullen	каллен
doro	доро
vladan	владан
lajunen	лаюнен
ajdukiewicz	айдукевич
takeaki	такэаки
harman	харман
blondel	блондель
delvecchio	дельвеккио
dandolo	дандоло
toriyama	торияма
moretti	моретти
artūras	артурас
stevo	стево
steinitz	стейниц
nordin	нордин
vangelis	вангелис
paulus	паулюс
diouf	диуф
kaji	кадзи
garofalo	гарофало
lech	лех
hagelin	хагелин
rhonda	ронда
matsumura	мацумура
chantal	шанталь
chin	чин
albertson	альбертсон
nell	нелл
mosley	мосли
mentuhotep	ментухотеп
mumford	мамфорд
šimić	шимич
lepage	лепаж
heine	гейне
goossens	гуссенс
finkel	финкель
soriano	сориано
alekseyev	алексеев
meira	мейра
pantelis	пантелис
moffat	моффат
rapp	рапп
frankel	франкель
ho	хо
mánes	манес
hopp	хопп
sharkey	шарки
mccabe	маккейб
amenemhat	аменемхет
spears	спирс
brendel	брендель
aisha	аиша
tautvilas	товтивил
forest	форест
ede	эде
kazuhiro	кадзухиро
diocles	диокл
feldman	фельдман
samvel	самвел
napolitano	наполитано
petković	петкович
branicki	браницкий
sakharov	сахаров
talib	талиб
penrose	пенроуз
holmberg	хольмберг
lisandro	лисандро
callimachi	каллимаки
gyulay	дьюлаи
lenski	ленски
toyoda	тоёда
padar	падар
söderström	сёдерстрём
bosman	босман
gervasio	хервасио
mabel	мэйбл
bergström	бергстрём
versace	версаче
vjekoslav	векослав
körner	кёрнер
cosgrove	косгроув
rutherford	резерфорд
bertalan	берталан
kido	кидо
saori	саори
livilla	ливилла
katalinić	каталинич
ulla	улла
yuki	юки
arminius	арминий
declan	деклан
spalding	сполдинг
hulk	халк
hekking	эккинг
siniša	синиша
mcmanus	макманус
raab	рааб
ure	юр
kieft	кифт
lady	леди
eötvös	этвёш
