nanthild	нантильда
herodotus	геродот
herodorus	геродор
treniota	тройнат
suintila	свинтила
piankh	пианх
gallienus	галлиен
seungri	сынри
timoxenos	тимоксен
sozomen	созомен
abulak	абулак
somerled	сомерлед
atisha	атиша
juanes	хуанес
slash	слэш
polyperchon	полиперхон
tsunku	цунку
arabo	арабо
uzziah	озия
menkare	менкара
anastacia	анастейша
pratinas	пратин
shorkaror	шеракарер
idmon	идмон
taeyang	тхэян
mogol	могол
euronymous	евронимус
hipparchus	гиппарх
ramanuja	рамануджа
aregund	арнегунда
prachanda	прачанда
pheidippides	фидиппид
urtaku	уртаки
buronson	буронсон
kalākaua	калакауа
brioc	бриак
oceana	осеана
audomar	аудомар
ferdowsi	фирдоуси
alluwamna	аллувамна
marcabru	маркабрюн
tato	тато
dingiswayo	дингисвайо
rahere	раэри
hincmar	гинкмар
clodoald	хлодоальд
maïwenn	майвенн
commodus	коммод
ermanaric	германарих
regiomontanus	региомонтан
quiteria	квитерия
tantamani	тануатамон
interpol	интерпол
morman	морван
pithana	питхана
megabates	мегабат
sahure	сахура
gunner	ганнер
chinesinho	шинесиньо
cnebba	кнебба
gorgias	горгий
nolito	нолито
iophon	иофон
twosret	таусерт
švitrigaila	свидригайло
evridiki	эвридики
esarhaddon	асархаддон
zorsines	зорсин
jonghyun	джонхён
amanineteyerike	аманинетеиерике
rivaldo	ривалдо
jucilei	жусилей
cynewald	киневальд
eurymedon	эвримедон
vrčak	врчак
narseh	нарсе
tiu	тиу
nongqawuse	нонгкавусе
micipsa	миципса
hermonax	гермонакс
stigand	стиганд
osceola	оцеола
samonas	самона
stańczyk	станчик
fenestella	фенестелла
milarepa	миларепа
odoacer	одоакр
endoeus	эндой
timoleon	тимолеонт
armatus	армат
triduana	тридуана
richarlyson	ришарлисон
tirigan	тирикан
megasthenes	мегасфен
alaungpaya	алаунпайя
jorginho	жоржиньо
philolaus	филолай
irnerius	ирнерий
shanice	шанис
ahaz	ахаз
aeschylus	эсхил
sisebut	сисебут
lactantius	лактанций
kalomira	каломира
lugalanda	лугальанда
nemarluk	немарлук
neymar	неймар
critolaus	критолай
ataulf	атаульф
erukhan	ерухан
incitatus	инцитат
mido	мидо
algodão	алгодао
khufu	хеопс
romaric	ромарик
hugobert	гугоберт
ankhesenamun	анхесенамон
pytheas	пифей
vicelinus	вицелин
sabium	сабиум
manorama	манорама
birutė	бирута
eratosthenes	эратосфен
gaugericus	гагерик
dembei	денбей
pythagoras	пифагор
callicratidas	калликратид
samium	самиум
odaenathus	оденат
demosthenes	демосфен
tostão	тостао
sisenand	сисенанд
morgause	моргауза
wenxiu	вэньсю
sitamun	ситамон
sequoyah	секвойя
ardo	ардо
dentinho	дентиньо
sassacus	сассакус
asclepiad	асклепиады
eugendus	евгенд
censorinus	цензорин
godigisel	годагисл
einhard	эйнхард
pruden	пруден
gaykhatu	гайхату
andrianampoinimerina	андрианампуанимерина
siranush	сирануйш
galaton	галатон
temnozor	темнозорь
estakhri	истахри
minggatu	мингату
cigoli	чиголи
tarako	тарако
shantideva	шантидэва
jebe	джэбэ
amphibalus	амфибал
iambulos	ямбул
edmílson	эдмилсон
khasekhemwy	хасехемуи
gaddar	гаддар
lysimachus	лисимах
kesha	кеша
borandukht	борандохт
perdigon	пердигон
pribina	прибина
flodoard	флодоард
dinostratus	динострат
ricardinho	рикардиньо
menaechmus	менехм
guntheuc	гунтека
athanagild	атанагильд
akhraten	ахратан
samoth	самот
pelopidas	пелопид
zito	зито
pentadius	пентадий
cratinus	кратин
iltutmish	илтутмиш
rabbula	раббула
epaphroditus	епафродит
babrius	бабрий
lulu	лулу
menkheperre	менхеперра
guercino	гверчино
mariamne	мариамна
lycortas	ликорт
majorian	майориан
vavá	вава
emenon	эменон
rodoald	родоальд
hunna	гунна
kapaakea	капаакеа
quini	кини
philostorgius	филосторгий
jotapianus	иотапиан
arvandus	арванд
yasu	ясу
tarpeia	тарпея
gundobad	гундобад
silbannacus	силбаннак
acamapichtli	акамапичтли
pyrrho	пиррон
nominoe	номиноэ
itta	итта
taixu	тайсюй
belisarius	велисарий
diwanus	дивон
vidyapati	видьяпати
mahavira	махавира
phintias	финтий
shamarpa	шамарпа
veerappan	вираппан
madius	мадий
satanta	сатанта
anmary	анмари
willibrord	виллиброрд
jogaila	ягайло
dexippus	дексипп
menes	менес
mistinguett	мистингетт
zalmoxis	залмоксис
hirohito	хирохито
shahzoda	шахзода
rikdag	рикдаг
gondioc	гундиох
gungunhana	гунгунхана
herihor	херихор
ostromir	остромир
averno	аверно
bionca	бионка
userkare	усеркара
theudoald	теодоальд
aristander	аристандр
baysonqor	байсонкур
limahl	лимал
skrillex	скриллекс
tenevil	теневиль
carausius	караузий
bodawpaya	бодопайя
papaflessas	папафлессас
ragenfrid	рагенфред
copsi	копси
bregowine	бреговин
anstrudis	анструда
onomarchus	ономарх
craterus	кратер
strachkvas	страхквас
peleg	фалек
chlodomer	хлодомир
alcibiades	алкивиад
benkei	бэнкэй
stoya	стоя
crixus	крикс
kerlon	керлон
hatshepsut	хатшепсут
dequinha	декинья
pleistarchus	плистарх
plectrude	плектруда
raageshwari	раджешвари
ramakrishna	рамакришна
origa	орига
balista	баллиста
alimqul	алимкул
athalaric	аталарих
basilina	василина
theramenes	ферамен
tzitzak	чичак
wansa	ванса
teshub	тешуб
lycophron	ликофрон
zequinha	зекинья
tenskwatawa	тенскватава
athanaric	атанарих
abanoub	анувий
jorane	жоран
onomacritus	ономакрит
hicetas	гикет
cynddylan	кинддилан
strez	стрез
ratislaus	ратислав
callisthenes	каллисфен
morcar	моркар
fernandão	фернандао
dengizich	денгизик
ninshō	нинсё
burgundofara	бургондофара
hegesippus	егесипп
bzikebi	бзикеби
lydos	лидос
puresh	пуреш
furqat	фуркат
unkei	ункэй
gudfred	гудфред
ariovistus	ариовист
theocritus	феокрит
alemão	алемао
mandakini	мандакини
triboulet	трибуле
giambologna	джамболонья
oltos	ольтос
gilgamesh	гильгамеш
kaidu	хайду
fergie	ферги
deco	деку
iphicrates	ификрат
alsou	алсу
absalon	абсалон
elemund	гелемунд
kirka	кирка
baderic	бадерих
psalmodius	псалмодий
moby	моби
arubani	арубаини
mabyn	мабенна
origen	ориген
muratsan	мурацан
charmadas	хармад
tertullian	тертуллиан
josemi	хосеми
tarrare	таррар
apuleius	апулей
tiradentes	тирадентис
hipponax	гиппонакт
chindasuinth	хиндасвинт
pushmataha	пушматаха
faxian	фасянь
teispes	теисп
hermeric	хермерих
coluche	колюш
vulca	вулка
csézy	чези
gritsamada	гритсамада
vasugupta	васугупта
öljaitü	олджейту
catanha	катанья
tatian	татиан
alcuin	алкуин
geberic	геберих
arnobius	арнобий
visunarat	висунарат
akeboshi	акэбоси
totila	тотила
rainiharo	райнихару
adalberon	адальберон
scholastica	схоластика
xenarchos	ксенарх
jovinus	иовин
aviamotornaya	авиамоторная
googoosh	гугуш
scopas	скопас
bryaxis	бриаксис
thrasybulus	фрасибул
menkaure	микерин
minervina	минервина
catald	катальд
perctarit	бертари
tonyukuk	тоньюкук
frederuna	фредеруна
donncoirce	доннкорки
sigga	сигга
tarkan	таркан
huneric	хунерих
hevia	хевиа
rhipsime	рипсимэ
chormaqan	чормаган
maru	мару
philetaerus	филитер
lacuzon	лакюзон
ilsinho	илсиньо
cimabue	чимабуэ
pentonville	пентонвиль
kelis	келис
proculus	прокул
senit	сенит
ebroin	эброин
domenichino	доменикино
setnakhte	сетнахт
bagyidaw	баджидо
ravachol	равашоль
thiruvalluvar	тируваллувар
athaliah	гофолия
arthelais	артелая
chabrias	хабрий
clitomachus	клитомах
bagoas	багой
bimbisara	бимбисара
vazul	вазул
thurisind	торисвинт
hauschka	хаушка
talakhamani	талакамани
calocaerus	калокер
wassaf	вассаф
yukana	юкана
nearchus	неарх
chenoa	ченоа
columbanus	колумбан
baruc	баррук
babur	бабур
archippus	архипп
heraclianus	гераклиан
viriathus	вириат
jádson	жадсон
sacagawea	сакагавея
huiyuan	хуэйюань
mélésville	мелесвиль
analmaye	аналмаи
massasoit	массасойт
athenaeus	афиней
dicaearchus	дикеарх
djedefre	джедефра
horemheb	хоремхеб
ferron	фэррен
harpocration	гарпократион
wermad	веомад
tissaphernes	тиссаферн
nimbarka	нимбарка
evodius	евод
hachikō	хатико
bezprym	безприм
pappo	паппо
taranatha	таранатха
hermocrates	гермократ
suelo	суэло
neot	неот
rachilde	рашильд
croesus	крёз
miou	миу
hōnen	хонэн
demades	демад
thusnelda	туснельда
damascius	дамаский
dōgen	догэн
shammuramat	шаммурамат
nichiren	нитирэн
fridianus	фридиан
babyface	бэйбифейс
gesalec	гезалех
ishtar	иштар
gampopa	гампопа
fridugisus	фридугис
tizoc	тисок
æthelstan	этельстан
mihirakula	михиракула
qutuz	кутуз
gildas	гильда
onew	оню
tankei	танкэй
godepert	годеперт
hostilian	гостилиан
teia	тейя
dattus	даттус
molière	мольер
eunus	евн
namatius	намаций
karunesh	карунеш
richimund	рехимунд
zendaya	зендая
alcman	алкман
sting	стинг
ricimer	рицимер
astennu	астенну
grifo	грифон
rasoherina	расухерина
actaeon	актеон
echion	аэтион
akhenaten	эхнатон
alecsandro	александро
sangharakshita	сангхаракшита
kidinnu	кидинну
islaja	ислайя
ralpacan	ралпачан
ealdred	элдред
sneferu	снофру
theudebald	теодебальд
pitikwahanapiwiyin	паундмейкер
philotas	филота
juca	жука
ḫaldi	халди
philochorus	филохор
aristagoras	аристагор
critias	критий
bacchylides	вакхилид
pinehesy	панехси
thorismund	торисмунд
vercingetorix	верцингеториг
emygdius	эмигдий
börte	бортэ
masinissa	массинисса
bencion	бенсио
plotinus	плотин
eurytus	еврит
tharrhypas	таррип
gervinho	жервиньо
tassac	тассах
yokozuna	ёкодзуна
huni	хуни
tribonian	трибониан
genial	жениал
dohasan	дохасан
ronaldinho	роналдиньо
thurstan	турстан
bâkî	бакы
tutankhamun	тутанхамон
twiggy	твигги
khafra	хафра
elipando	элипанд
potap	потап
lapu	лапу
hypereides	гиперид
bolad	болад
dosoftei	дософтей
pantaenus	пантен
superfecundation	суперфекундация
machabeli	мачабели
garrincha	гарринча
athracht	аттракта
djedkhonsuefankh	джедхонсуефанх
meja	мея
eupolis	евполид
bartatua	партатуа
zwentibold	цвентибольд
cypselus	кипсел
birbal	бирбал
pacatianus	пакациан
valmiki	вальмики
ulpian	ульпиан
framta	фрамтан
terpander	терпандр
daugirutis	довгерд
naropa	наропа
hypsicles	гипсикл
archimedes	архимед
harmoko	хармоко
aleijadinho	алейжадинью
brahmagupta	брахмагупта
toqtaqiya	токтакия
aenesidemus	энесидем
hakor	ахорис
capucine	капучине
longchenpa	лонгченпа
keirrison	кейррисон
rintaro	ринтаро
ctesias	ктесий
kajol	каджол
ulaghchi	улагчи
fazang	фацзан
numerian	нумериан
natakamani	натакамани
prajadhipok	прачадипок
richbod	рихбод
shagrath	шаграт
bramantino	брамантино
leucippus	левкипп
aristion	аристион
lura	лура
pérotin	перотин
gorazd	горазд
dignāga	дигнага
sudirman	судирман
pinturicchio	пинтуриккьо
tribhuvanāditya	трибхуванадитьяварман
kalulu	калулу
koke	коке
elagabalus	гелиогабал
bahmanyār	бахманяр
stendhal	стендаль
sikelgaita	сишельгаита
peisistratos	писистрат
chulalongkorn	чулалонгкорн
josimar	жозимар
bénabar	бенабар
harpalus	гарпал
arouca	ароука
nǃxau	нкъхау
zico	зико
teoman	теоман
columella	колумелла
tulsidas	тулсидас
lutipri	лутипри
zuqaqip	зукакип
pasquitan	паскветен
shebitku	шабатака
wovoka	вовока
enravota	енравота
siptah	саптах
maironis	майронис
bienheuré	бьеноре
macrinus	макрин
quarentinha	куарентинья
dela	дела
placentinus	плацентин
vitiges	витигес
ansegisel	анзегизель
nilmar	нилмар
shammai	шаммай
theognostus	феогност
gervadius	герват
tooji	туджи
bisinus	бизин
prasutagus	прасутаг
oenomaus	эномай
welliton	веллитон
santigold	сантиголд
austromoine	австремоний
cunipert	куниперт
audoin	аудоин
urmuz	урмуз
meinwerk	майнверк
merikare	мерикара
shitao	шитао
antinous	антиной
jien	дзиэн
anggun	анггун
cunibert	куниберт
matfrid	матфрид
nefertiti	нефертити
narimantas	наримунт
nakashidze	накашидзе
glaucetas	главкет
hammurabi	хаммурапи
alboin	альбоин
gelimer	гелимер
sponsianus	спонсиан
washakie	вашаки
alulim	алулим
squanto	сквонто
marlos	марлос
cleitarchus	клитарх
naplanum	напланум
kamose	камос
costinha	коштинья
khulan	хулан
asanga	асанга
buddhadasa	буддхадаса
kalumum	калумум
eber	евер
rihanna	рианна
huineng	хуэйнэн
donatello	донателло
phrynichus	фриних
aspasia	аспасия
bozh	бож
authari	аутари
mahalalel	малелеил
theudis	теудис
brennus	бренн
bassianus	бассиан
eadmer	эдмер
nithard	нитгард
brassaï	брассай
agui	агуй
herostratus	герострат
digão	дигао
erinna	эринна
burebista	буребиста
malewiebamani	малиевиебамани
srinagarindra	шринагариндра
zelão	зелао
userkaf	усеркаф
tyagaraja	тьягараджа
audovera	аудовера
dobrynya	добрыня
tekuder	текудер
jairzinho	жаирзиньо
aneirin	анейрин
nek	нек
ay	эйе
ryback	райбек
jakuren	дзякурэн
varāhamihira	варахамихира
zinho	зиньо
mesilim	месилим
shahbanu	шахбану
enheduanna	энхедуанна
reu	рагав
indutiomarus	индуциомар
detsl	децл
zaleucus	залевк
yajnavaraha	яджнавараха
rededya	редедя
sobekneferu	нефрусобек
albucilla	альбуцилла
hunico	унико
sitalces	ситалк
scribonia	скрибония
bardiya	бардия
evasius	эвазий
śūdraka	шудрака
tolui	толуй
wasashatta	васашатта
ermenguer	эрменгер
elano	элано
peirol	пейроль
timocharis	тимохарис
charilaus	харилай
eknath	экнатх
urukagina	уруинимгина
doryssus	дорисс
terentia	теренция
trocundus	трокунд
dromtön	дромтонпа
hanging	повешение
sariputta	шарипутра
candrakīrti	чандракирти
shakira	шакира
shaggy	шэгги
balih	балих
datis	датис
eutropius	евтропий
nabis	набис
parmenion	парменион
leeteuk	итхык
rakim	раким
evagoras	эвагор
daskalogiannis	даскалояннис
nabonidus	набонид
sunderolt	зундерольд
ashurbanipal	ашшурбанапал
oribasius	орибасий
aryabhata	ариабхата
etana	этана
ulanhu	уланьфу
olympius	олимпий
sophocles	софокл
posidonius	посидоний
sadalberga	салаберга
aistulf	айстульф
tadukhipa	тадухепа
wallia	валия
radagaisus	радагайс
bhavyaviveka	бхававивека
popé	попе
rumiñahui	руминьяви
sudharmono	судармоно
onoulphus	онульф
xanthippe	ксантиппа
lunalilo	луналило
adherbal	адгербал
teru	тэру
drahomíra	драгомира
cinioch	киниох
liédson	лиедсон
gaitana	гайтана
laches	лахет
glele	глеле
mazdak	маздакизм
canaletto	каналетто
coanacoch	коанакочцин
regalianus	регалиан
polyaenus	полиэн
zeuxis	зевксис
sosei	сосэй
tonel	тонел
ikunum	икунум
madhukar	мадукар
joselu	хоселу
weegee	уиджи
onkelos	онкелос
fernandinho	фернандиньо
radegund	радегунда
toyen	тойен
koceľ	коцел
franciabigio	франчабиджо
euric	эйрих
jentina	джентина
xenocles	ксенокл
sridevi	шридеви
nelinho	нелиньо
abhinavagupta	абхинавагупта
allectus	аллект
enkū	энку
joãozinho	жоазиньо
vieirinha	виейринья
sennacherib	синаххериб
budgie	баджи
naresuan	наресуан
ammuna	аммуна
megacles	мегакл
elulu	элили
cochise	кочис
hogzilla	хогзилла
fibonacci	фибоначчи
jaimini	джаймини
pujie	пуцзе
jugurtha	югурта
mellitus	меллит
fernandel	фернандель
hansken	ханскен
heffter	гефтер
zoilus	зоил
mongkut	монгкут
yennenga	йененга
tintoretto	тинторетто
sunniva	суннива
karigaila	каригайло
carneades	карнеад
rainivoninahitriniony	райнивунинахитриниуни
betão	бетао
terah	фарра
bourvil	бурвиль
arikhankharer	ариканкарер
tjokroaminoto	чокроаминото
hydatius	идаций
parshatatar	паршататар
mcg	макджи
alopen	алобэнь
cuilén	кулен
corippus	корипп
canachus	канах
giric	гирик
himiko	химико
kandalanu	кандалану
malchik	сочувствие
onesilus	онесил
campino	кампино
cynane	кинана
palladas	паллад
cunimund	кунимунд
malú	малу
gangotri	ганготри
pocahontas	покахонтас
butigeidis	будикид
columba	колумба
ahab	ахав
zetti	дзетти
avicii	авичи
caracalla	каракалла
phraortes	фраорт
charidemus	харидем
ekkathat	экатхат
lamachus	ламах
pleistoanax	плистоанакт
huitzilihuitl	уилицилипутль
stobaeus	стобей
hatuey	атуэй
tenmon	тэммон
decebalus	децебал
owon	овон
charmides	хармид
madhubala	мадхубала
massiel	массиель
lulinha	лулинья
anthemiolus	антемиол
angulimala	ангулимала
ospitone	госпитон
recceswinth	реккесвинт
rāhula	рахула
kshemaraja	кшемараджа
ardagast	ардагаст
kālidāsa	калидаса
pahiño	паиньо
teleclus	телекл
putyata	путята
armik	армик
erwig	эрвиг
nynetjer	нинечер
ingulf	ингульф
cottius	коттий
indulf	индульф
andradina	андрадина
suggs	саггс
laelianus	лелиан
caçapa	касапа
atilia	атилия
psammuthes	псаммут
zizinho	зизиньо
japheth	иафет
sayana	саяна
jamala	джамала
rehoboam	ровоам
niginho	нижиньо
apoño	апоньо
euphronios	евфроний
euctemon	евктемон
alalngar	аллалгар
fredegund	фредегонда
stotzas	стотца
sirusho	сирушо
caravelli	каравелли
roxelana	роксолана
eminem	эминем
tudwal	тудвал
guillemundus	гильемунд
soko	соко
mariza	мариза
dalida	далида
chararic	харарих
libanius	либаний
siamanto	сиаманто
mustis	мустис
verginia	виргиния
acusilaus	акусилай
taibuga	тайбуга
protagoras	протагор
epaminondas	эпаминонд
hoelun	оэлун
mahendravarman	махендраварман
geronimo	джеронимо
vaišvilkas	войшелк
anaxander	анаксандр
nicias	никий
sanctorius	санторио
anitta	анитта
nangklao	чессадабодиндра
vytenis	витень
subutai	субэдэй
munderic	мундерих
saichō	сайтё
gunderic	гундерих
tisias	тисий
buriana	буриана
hizaki	хидзаки
kisaki	кисаки
kruto	круто
walthari	вальтари
godeberta	годеберта
pharaildis	фараильда
topsy	топси
epimenides	эпименид
jivani	дживани
anacreon	анакреонт
raginpert	рагинперт
euhemerus	эвгемер
madhvacharya	мадхва
dausprungas	довспрунк
ibson	ибсон
vampiro	вампиро
icarus	икар
blandina	бландина
mazaeus	мазей
onesimos	онесим
cacau	какау
mamai	мамай
liliuokalani	лилиуокалани
fréhel	фреэль
arwium	арвиум
sanai	санаи
euspicius	евспикий
ahuitzotl	ауисотль
aldair	алдаир
hephaestion	гефестион
shivaji	шиваджи
hucbert	хукберт
sampiro	сампиро
taliesin	талиесин
erispoe	эриспоэ
rembrandt	рембрандт
ennin	эннин
leonnatus	леоннат
eubulides	евбулид
masaccio	мазаччо
ashoka	ашока
achaeus	ахей
maldras	мальдра
yarlagab	ярлагаб
wilopo	вилопо
sadyattes	садиатт
exekias	эксекий
enya	эния
nadar	надар
ansgar	ансгар
stasinus	стасин
maudgalyayana	маудгальяяна
polygnotos	полигнот
balto	балто
hesiod	гесиод
jamba	жамба
paíto	паиту
austol	аустоль
hsinbyushin	синбьюшин
panamarenko	панамаренко
britches	бричес
themistius	фемистий
alghu	алгу
chremonides	хремонид
flea	фли
sarlagab	сарлагаб
philopoemen	филопемен
aspelta	аспелта
ibycus	ивик
cyriades	кириад
peithon	пифон
frumar	фрумар
ildibad	ильдебад
aśvaghoṣa	ашвагхоша
vlastimir	властимир
sylvinho	силвиньо
chanakya	чанакья
akon	эйкон
ursmar	урсмар
russya	руся
merenhor	меренхор
stesichorus	стесихор
eleutherius	элефтерий
śāntarakṣita	шантаракшита
leosthenes	леосфен
crantor	крантор
dagoberto	дагоберто
hornswoggle	хорнсвоггл
ishpaka	ишпакай
nagarjuna	нагарджуна
syphax	сифакс
spitamenes	спитамен
eadwig	эдвиг
polycrates	поликрат
kaliopi	калиопи
boediono	будионо
chimalpopoca	чимальпопока
herodias	иродиада
rimush	римуш
reineldis	рейнельда
matuzalém	матузалем
romário	ромарио
semaun	семаун
seryoga	серёга
everaldo	эвералдо
comanche	команч
lekain	лёкен
locusta	локуста
acius	акий
cicinho	сисиньо
aspasius	аспасий
marozia	марозия
souphanouvong	суфанувонг
kimbra	кимбра
fininho	фининьо
onir	онир
wols	вольс
cleph	клеф
sadigjan	садыхджан
aybak	айбек
satprem	сатпрем
aedesius	эдесий
frankmusik	фрэнкмьюзик
galswintha	галесвинта
sanila	санила
polybius	полибий
jianzhen	гандзин
ciara	сиара
hyperbatas	гипербат
kūkai	кукай
lulach	лулах
glycerius	глицерий
willigis	виллигиз
imi	ими
aldhelm	альдхельм
isembart	изембарт
mahākāśyapa	махакашьяпа
dwynwen	дуйнвен
amelius	амелий
nostradamus	нострадамус
gimax	джимакс
eisai	эйсай
vampeta	вампета
sengzhao	сэнчжао
skanderbeg	скандербег
amalaric	амаларих
chram	храмн
tlacaelel	тлакаелель
khyan	хиан
rudaki	рудаки
alahis	алагис
muqali	мухали
thucydides	фукидид
nezahualcoyotl	несауалькойотль
liutpert	лиутперт
nennius	ненний
socks	сокс
rutebeuf	рютбёф
apries	априй
dobrotitsa	добротица
amanikhabale	аманихабале
oreco	ореко
tyrtaeus	тиртей
mundus	мунд
matisyahu	матисьяху
draco	дракон
yovanna	йованна
buddhaghosa	буддхагхоша
neferkauhor	неферкаухор
momus	момус
shinran	синран
shunkan	сюнкан
manishtushu	маништушу
lemmy	лемми
demasduit	демасдуит
bonosus	боноз
manvydas	монтвид
shabaka	шабака
balthus	бальтюс
gundemar	гундемар
shivini	шивини
mardonius	мардоний
amanitore	аманиторе
jasmuheen	джасмухин
nezahualpilli	несауальпилли
zózimo	зозимо
jeconiah	иехония
fulvia	фульвия
qulpa	кульпа
chandidas	чандидас
soeprapto	супрапто
kujira	кудзира
isaeus	исей
laika	лайка
taharqa	тахарка
chilaun	чилаун
paramartha	чжэньди
kekaumenos	кекавмен
amenmesse	аменмес
arnoald	арноальд
hypatia	гипатия
boroldai	бурундай
gungunum	гунгунум
omarion	омарион
maharbal	магарбал
priscillian	присциллиан
sirikit	сирикит
kuchum	кучум
henjo	хэндзё
amyrtaeus	амиртей
jarboe	джарбо
seljuk	сельджук
maroboduus	маробод
harsiotef	горсиотеф
valamir	валамир
hidulf	хидульф
aioulf	агривульф
fabão	фабан
ingund	ингунда
huáscar	уаскар
unsuri	унсури
sibawayh	сибавейхи
iamblichus	ямвлих
alferius	алферио
bardaisan	бардесан
jovian	иовиан
farinelli	фаринелли
hemiunu	хемиун
pollo	польо
psiax	псиакс
aspar	аспар
tacfarinas	такфаринат
isutoshi	исутоси
sheram	шерам
grock	грок
telipinu	телепину
prodicus	продик
averroism	аверроизм
methuselah	мафусаил
ionatana	ионатана
živinbudas	живибунд
mañjuśrīmitra	манджушримитра
kanzi	канзи
gugunava	гугунава
itzcoatl	ицкоатль
bindusara	биндусара
harthacnut	хардекнуд
careca	карека
arrian	арриан
himelin	химелин
pelops	пелоп
waltrude	вальдетруда
cytherea	цитерия
mana	мана
zanabazar	дзанабадзар
miliduch	милидух
cunobeline	кунобелин
mazaris	мазарис
erridupizir	эрридупизир
tahurwaili	тахурваили
mista	миста
caravaggio	караваджо
kitbuqa	китбука
malaria	малярия
eperatus	эперат
illtud	ильтуд
nakhshabi	нахшаби
isocrates	исократ
tatikios	татикий
viestards	виестартс
novatian	новациан
smaragdus	смарагд
periander	периандр
yashpal	яшпал
leivinha	лейвинья
barbatio	барбацион
clodoaldo	клодоалдо
melchizedek	мелхиседек
edigu	едигей
berossus	берос
anaximander	анаксимандр
shepseskaf	шепсескаф
vikramāditya	викрамадитья
tjodalv	тьодальв
pausias	павзий
posidippus	посидипп
derlei	дерлей
subandrio	субандрио
khabash	хабабаш
heremigarius	хермигар
jochi	джучи
diocletian	диоклетиан
sarbel	сарбель
myōe	мёэ
netjerkare	нечерикара
pindar	пиндар
manetho	манефон
masaniello	мазаньелло
pontormo	понтормо
shaushtatar	шауштатар
metacomet	метакомет
thrasamund	тразамунд
leotychidas	леотихид
canário	канарио
parmenides	парменид
parsbit	парсбит
thankmar	танкмар
chafurin	тяфурин
onesicritus	онесикрит
barquq	баркук
amanikhatashan	аманикаташан
maughold	могольд
silenoz	силенос
sompou	сомпху
ligalize	лигалайз
piye	пианхи
anandavardhana	анандавардхана
bebeto	бебето
anvari	анвари
serug	серух
democritus	демокрит
stenkil	стенкиль
fulcran	фулькран
visakha	вишакха
menua	менуа
bulchan	блучан
theispas	тейшеба
trentemøller	трентемёллер
thurcytel	туркетиль
pamprepius	пампрепий
cucuphas	кукуфас
capleton	каплетон
siamun	сиамон
emika	эмика
djalminha	джалминья
ghezo	гезо
ronglu	жунлу
angilbert	ангильберт
rekhmire	рехмира
winwaloe	гвеноле
musidora	мюзидора
béhanzin	беханзин
agatharchus	агафарх
aristoxenus	аристоксен
ricfried	рикфрид
copi	копи
govi	гови
brandãozinho	бранданзиньо
neferkahor	неферкахор
akihito	акихито
devota	девота
riothamus	риотам
brasidas	брасид
narses	нарсес
abran	абран
meskalamdug	мескаламдуг
laborec	лаборец
vydūnas	видунас
garou	гару
kaumualii	каумуалии
jamukha	джамуха
mazinho	мазиньо
trebellianus	требеллиан
xandão	шандан
acarius	акарий
xenophanes	ксенофан
ouida	уида
cherepanovs	черепановы
siaspiqa	сиаспика
britannicus	британник
gobryas	гобрий
katyayana	катьяяна
eurycrates	еврикрат
grafite	графите
eraric	эрарих
bucephalus	буцефал
cazuza	казуза
thrasymachus	фрасимах
chrysippus	хрисипп
zenobia	зенобия
boniak	боняк
shanakdakhete	шанакдакете
adaloald	аделоальд
lucebert	люсеберт
mzilikazi	мзиликази
khidr	хидр
fritigern	фритигерн
feyrouz	фейруз
cacamatzin	какамацин
maniche	манише
abadios	авадий
salvian	сальвиан
banksy	бэнкси
euripides	еврипид
bryher	брайхер
wittiza	витица
axayacatl	ашаякатль
tomatito	томатито
euthymides	евфимид
uldin	улдин
saturnina	сатурнина
sennedjem	сеннеджем
cuitláhuac	куитлауак
siemomysł	земомысл
engelberga	ангельберга
tukaram	тукарам
curiatius	куриации
wigstan	вигстан
wilgefortis	вильгефортис
theodectes	теодект
ziying	цзыин
mashda	машда
ariamir	ариамир
poonthanam	пунтханам
sappho	сапфо
adwaita	адвайта
kumārajīva	кумараджива
gunthamund	гунтамунд
lembitu	лембиту
noemi	ноэми
aristillus	аристилл
czimislav	цзимислав
blacatz	блакац
cleanthes	клеанф
theodahad	теодахад
witteric	виттерих
vasubandhu	васубандху
ceará	сеара
victricius	виктриций
synesius	синезий
younha	юнха
aristocreon	аристокреон
teleutias	телевтий
phocion	фокион
hazael	азаил
azarmidokht	азармедохт
herophilos	герофил
momchil	момчил
adunis	адонис
padmasambhava	падмасамбхава
wihomarc	виомарк
hamacarus	хамакар
cercamon	серкамон
arletty	арлетти
alciphron	алкифрон
schanz	шанц
deiotarus	дейотар
naldo	налдо
zotto	зотто
turgesius	тургейс
anugama	анугама
lacedaimonius	лакедемоний
momik	момик
vedast	ведаст
ruffian	резвая
bakenranef	бокхорис
nabonassar	набонасар
vetranio	ветранион
oroles	орол
wiborada	виборада
abbán	аббан
chingünjav	чингунжав
diponegoro	дипонегоро
deioces	дейок
rikishi	рикиши
hachiun	хачиун
boudica	боудикка
manucho	манушу
theano	феано
liuvigild	леовигильд
manuchehri	манучехри
maimonides	маймонид
surdas	сурдас
amalasuntha	амаласунта
chintila	хинтила
mindarus	миндар
ardaric	ардарих
cædmon	кэдмон
gudula	гудула
hecatomnus	гекатомн
arash	араш
epicurus	эпикур
speusippus	спевсипп
demaratus	демарат
aurangzeb	аурангзеб
yesühei	есугей
nonnosus	ноннос
agobard	агобард
uurad	вурад
novalis	новалис
mausolus	мавсол
genshin	гэнсин
skirgaila	скиргайло
washoe	уошо
gausbert	госберт
hierocles	гиерокл
pulcheria	пульхерия
nabopolassar	набопаласар
hernanes	эрнанес
aphrahat	афраат
toqta	тохта
tilopa	тилопа
malbim	малбим
ingenuus	ингенуй
nampeyo	нампейо
wacho	вахо
shattiwaza	шаттиваза
rashi	раши
quintillus	квинтилл
cleophon	клеофонт
moralia	моралии
milva	мильва
niklot	никлот
xuanzang	сюаньцзан
maxentius	максенций
polaire	полер
barsine	барсина
zoroaster	заратустра
vaidila	войдило
zumbi	зумби
serchmaa	сэрчмаа
pattimura	паттимура
galba	гальба
rechiar	рехиар
dnyaneshwar	джнянешвар
ingelger	ингельгер
kaʻahumanu	каауману
robinho	робиньо
ictinus	иктин
aspazija	аспазия
kurszán	курсан
setthathirath	сеттатират
pami	пами
artashumara	арташшумара
caribou	карибу
buddhapālita	буддапалита
giorgione	джорджоне
hotepsekhemwy	хотепсехемуи
enchin	энтин
onesimus	онисим
rechila	рехила
aisiqi	айсыци
báb	баб
vajiravudh	вачиравудх
gilla	гилла
tarcisius	тарцизий
rainilaiarivony	райнилайаривуни
galerius	галерий
histiaeus	гистией
rafinha	рафинья
cratylus	кратил
pisanello	пизанелло
bilichild	билихильда
quorthon	куортон
snuppy	снуппи
hermippus	гермипп
confucius	конфуций
muhannad	муханнад
kirta	кирта
kiesewetter	кизеветтер
trugernanner	труганини
etto	этто
archilochus	архилох
zopyrion	зопирион
thrasco	дражко
quartus	куарт
leilton	леилтон
callicrates	калликрат
nayer	найер
caupolicán	кауполикан
scheherazade	шахерезада
bulbuljan	бюльбюльджан
theudigisel	теудигизел
ulfilas	вульфила
antiphanes	антифан
hergé	эрже
bleda	бледа
genseric	гейзерих
eutropia	евтропия
astrix	астрикс
hadise	хадисе
hyperbolus	гипербол
antalcidas	анталкид
paracelsus	парацельс
weetamoo	уитаму
sheba	савей
ashanti	ашанти
remismund	ремисмунд
agabus	агав
elpinice	эльпиника
rigunth	ригунта
shvarn	шварн
mantorras	манторраш
dondinho	дондиньо
chisu	кису
tesourinha	тезоуринья
erasistratus	эрасистрат
vecchietta	веккьетта
nestorius	несторий
bigode	бигоде
banine	банин
merneptah	мернептах
chimalpahin	чимальпаин
theodwin	теодвин
temüge	тэмуге
alcinous	алкиной
dōkyō	докё
bulbul	бюльбюль
ansprand	анспранд
osgyth	осита
hunefer	хунефер
staurakios	ставракий
ryan	райан
scott	скотт
federico	федерико
roberto	роберто
johnson	джонсон
barbara	барбара
enrico	энрико
franco	франко
giuseppe	джузеппе
brad	брэд
alfred	альфред
steve	стив
goran	горан
palladius	палладий
liu	лю
giacomo	джакомо
milan	милан
andy	энди
nicole	николь
donald	дональд
amanda	аманда
vincenzo	винченцо
gunnar	гуннар
jennifer	дженнифер
emma	эмма
santiago	сантьяго
ben	бен
nigel	найджел
trevor	тревор
fritz	фриц
jack	джек
norbert	норберт
harris	харрис
glenn	гленн
kevin	кевин
shane	шейн
terry	терри
anita	анита
jason	джейсон
luigi	луиджи
miller	миллер
adam	адам
jerzy	ежи
alessandro	алессандро
smith	смит
oliver	оливер
jones	джонс
marina	марина
andrzej	анджей
bobby	бобби
nina	нина
zhang	чжан
mika	мика
pietro	пьетро
anders	андерс
tobias	тобиас
andrea	андреа
max	макс
thomas	томас
sandra	сандра
brett	бретт
keller	келлер
moore	мур
willis	уиллис
lars	ларс
aristophanes	аристофан
hiroshi	хироси
zdeněk	зденек
alejandro	алехандро
samo	само
takashi	такаси
carlo	карло
cole	коул
carter	картер
lisa	лиза
gardner	гарднер
hall	холл
arturo	артуро
dana	дана
mario	марио
kyle	кайл
ivo	иво
salvatore	сальваторе
williams	уильямс
didier	дидье
timbaland	тимбалэнд
skalmantas	сколоменд
nammalvar	наммальвар
chuck	чак
parker	паркер
schmidt	шмидт
tadeusz	тадеуш
nelson	нельсон
géza	геза
king	кинг
nancy	нэнси
dennis	деннис
gustavo	густаво
rodolfo	родольфо
marcel	марсель
dieter	дитер
allen	аллен
alain	ален
jackson	джексон
white	уайт
maurice	морис
nick	ник
mick	мик
gibson	гибсон
rolf	рольф
jānis	янис
darren	даррен
tommaso	томмазо
guillermo	гильермо
jessica	джессика
james	джеймс
warren	уоррен
tom	том
dragan	драган
jules	жюль
john	джон
brendan	брендан
phil	фил
tyler	тайлер
martina	мартина
imre	имре
zoran	зоран
simpson	симпсон
riley	райли
adriano	адриано
andrew	эндрю
olivier	оливье
marek	марек
boris	борис
nenad	ненад
colin	колин
alan	алан
xu	сюй
ford	форд
roth	рот
renato	ренато
francesco	франческо
josip	йосип
wojciech	войцех
meir	меир
grant	грант
norman	норман
dino	дино
takahashi	такахаси
jörg	йорг
dejan	деян
george	джордж
tommy	томми
wood	вуд
timo	тимо
todd	тодд
josh	джош
wolfgang	вольфганг
wright	райт
antonín	антонин
zbigniew	збигнев
ashley	эшли
boyd	бойд
spencer	спенсер
rita	рита
adler	адлер
ingrid	ингрид
evans	эванс
william	уильям
anderson	андерсон
ron	рон
ramos	рамос
hill	хилл
carmen	кармен
anton	антон
liam	лиам
joyce	джойс
predrag	предраг
željko	желько
bartolomeo	бартоломео
horst	хорст
kathleen	кэтлин
andreas	андреас
ferenc	ференц
larry	ларри
amir	амир
patrice	патрис
shirley	ширли
andersen	андерсен
alex	алекс
byron	байрон
matti	матти
virginia	вирджиния
ruslan	руслан
harald	харальд
einar	эйнар
barnes	барнс
zhou	чжоу
walsh	уолш
sándor	шандор
darko	дарко
nakamura	накамура
audrey	одри
janne	янне
kobayashi	кобаяси
logan	логан
wagner	вагнер
knut	кнут
armstrong	армстронг
derek	дерек
ross	росс
olga	ольга
gaetano	гаэтано
girolamo	джироламо
jeremy	джереми
cohen	коэн
clifford	клиффорд
mirza	мирза
miklós	миклош
rebecca	ребекка
lajos	лайош
christopher	кристофер
greg	грег
suzuki	судзуки
roman	роман
kenny	кенни
bojan	боян
rex	рекс
jim	джим
erin	эрин
sanders	сандерс
stig	стиг
hiroyuki	хироюки
peggy	пегги
ettore	этторе
berry	берри
tanaka	танака
inoue	иноуэ
marcello	марчелло
gina	джина
chavchavadze	чавчавадзе
west	уэст
valentina	валентина
arnold	арнольд
vicente	висенте
edgar	эдгар
karen	карен
dawson	доусон
chris	крис
ernesto	эрнесто
jens	йенс
piero	пьеро
williamson	уильямсон
dimitrios	димитриос
newton	ньютон
massimo	массимо
bella	белла
pascal	паскаль
vernon	вернон
cynthia	синтия
robinson	робинсон
giuliano	джулиано
wayne	уэйн
morton	мортон
mitchell	митчелл
paavo	пааво
drake	дрейк
gao	гао
hu	ху
barrett	барретт
fontana	фонтана
meredith	мередит
oswald	освальд
alexis	алексис
glen	глен
stone	стоун
hansen	хансен
janusz	януш
phillips	филлипс
edwards	эдвардс
bruce	брюс
jacek	яцек
doris	дорис
edmund	эдмунд
zhao	чжао
norris	норрис
wim	вим
maurizio	маурицио
akira	акира
wilkinson	уилкинсон
tito	тито
petra	петра
ivica	ивица
juraj	юрай
kenji	кэндзи
sue	сью
fox	фокс
jana	яна
morgan	морган
gerhard	герхард
chen	чэнь
istván	иштван
jane	джейн
ivan	иван
cliff	клифф
harvey	харви
mike	майк
perry	перри
sheridan	шеридан
dušan	душан
sterling	стерлинг
armando	армандо
brothers	братья
wei	вэй
patrick	патрик
alberto	альберто
cooper	купер
bill	билл
rosenthal	розенталь
rupert	руперт
svetlana	светлана
gérard	жерар
porter	портер
dick	дик
eugène	эжен
sam	сэм
egon	эгон
stella	стелла
quinn	куинн
witold	витольд
sherman	шерман
antanas	антанас
alicia	алисия
brennan	бреннан
ion	ион
ashikaga	асикага
lara	лара
ragnar	рагнар
holger	хольгер
davide	давиде
lance	лэнс
alexandros	александрос
aldo	альдо
vittorio	витторио
holden	холден
whitney	уитни
gero	геро
lennart	леннарт
gino	джино
snow	сноу
ruslana	руслана
julián	хулиан
saadi	саади
traoré	траоре
derrick	деррик
gu	гу
liang	лян
jovan	йован
morten	мортен
slobodan	слободан
hernán	эрнан
rory	рори
baxter	бакстер
emilio	эмилио
fuchs	фукс
hartley	хартли
aaron	аарон
lewis	льюис
robbins	роббинс
domenico	доменико
tibor	тибор
bell	белл
vanessa	ванесса
richardson	ричардсон
mariano	мариано
ward	уорд
powell	пауэлл
hart	харт
otto	отто
gordon	гордон
filippo	филиппо
zoltán	золтан
sven	свен
butler	батлер
walton	уолтон
fuller	фуллер
gregor	грегор
hunter	хантер
crawford	кроуфорд
will	уилл
mann	манн
lloyd	ллойд
laurent	лоран
von	фон
radu	раду
lauri	лаури
schneider	шнайдер
barker	баркер
bauer	бауэр
thornton	торнтон
moshe	моше
olivia	оливия
koch	кох
roberts	робертс
jenkins	дженкинс
griffin	гриффин
palmer	палмер
banks	бэнкс
rubin	рубин
sammy	сэмми
jenna	дженна
rod	род
tim	тим
tamara	тамара
felice	феличе
jános	янош
serge	серж
andersson	андерссон
joshua	джошуа
robertson	робертсон
carpenter	карпентер
bradley	брэдли
ali	али
mitch	митч
pericles	перикл
koryun	корюн
brenda	бренда
perkins	перкинс
ramananda	рамананда
comgall	комгалл
zemfira	земфира
pupienus	пупиен
nolan	нолан
polemon	полемон
ephialtes	эфиальт
carroll	кэрролл
farrell	фаррелл
viola	виола
juris	юрис
rodney	родни
pertinax	пертинакс
gregg	грегг
art	арт
felgenhauer	фельгенгауэр
ramesses	рамсес
prudentius	пруденций
włodzimierz	влодзимеж
penn	пенн
benedetto	бенедетто
sosthenes	сосфен
kaloyan	калоян
vince	винс
krum	крум
seka	сека
mladen	младен
neferkamin	неферкамин
sosa	соса
mauro	мауро
pausanias	павсаний
rotaru	ротару
sabinianus	сабиниан
dante	данте
huber	хубер
vitellius	вителлий
phaedrus	федр
plutarch	плутарх
gelo	гелон
nepotianus	непоциан
zenodorus	зенодор
constantina	константина
salomé	саломе
benson	бенсон
humayun	хумаюн
ursicinus	урсицин
ferrari	феррари
aristippus	аристипп
hildeprand	гильдепранд
mariusz	мариуш
avitus	авит
hippias	гиппий
meleager	мелеагр
deusdedit	деусдедит
matt	мэтт
edwin	эдвин
matteo	маттео
chester	честер
flynn	флинн
jonathan	джонатан
bennett	беннетт
collins	коллинз
leonid	леонид
kapoor	капур
cunningham	каннингем
allan	аллан
singh	сингх
hughes	хьюз
maxwell	максвелл
miloš	милош
erich	эрих
jamie	джейми
salvador	сальвадор
duffy	даффи
griffith	гриффит
józsef	йожеф
terence	теренс
avi	ави
paolo	паоло
javier	хавьер
rob	роб
antonio	антонио
bond	бонд
jacobsen	якобсен
fabrizio	фабрицио
béla	бела
esteban	эстебан
tal	таль
pedersen	педерсен
sinclair	синклер
del	дель
lucien	люсьен
preston	престон
rené	рене
claudio	клаудио
samir	самир
kennedy	кеннеди
ruiz	руис
swami	свами
vladimir	владимир
naomi	наоми
arvid	арвид
grzegorz	гжегож
erhard	эрхард
adamson	адамсон
pamela	памела
hubbard	хаббард
florian	флориан
samantha	саманта
dorothy	дороти
morrison	моррисон
axel	аксель
cesare	чезаре
owen	оуэн
ivanov	иванов
aldegonde	адельгунда
meryre	мерира
santillana	сантильяна
taurinus	таврин
frança	франса
bronisław	бронислав
sami	сами
theodelinda	теоделинда
theophanu	феофано
jari	яри
tokhtamysh	тохтамыш
makron	макрон
hippo	гиппон
douris	дурис
sheldon	шелдон
bernd	бернд
saloninus	салонин
nuno	нуну
favorinus	фаворин
jill	джилл
cleon	клеон
ingo	инго
walters	уолтерс
persius	персий
kaká	кака
raí	раи
traidenis	тройден
ante	анте
marullus	марулл
maggie	мэгги
teddy	тедди
attila	аттила
giottino	джоттино
donna	донна
korniliy	корнилий
sigeric	сигерик
moon	мун
vainius	воин
habakkuk	аввакум
roderic	родерих
pasquale	паскуале
gertrude	гертруда
madonna	мадонна
charlot	шарло
jubal	иувал
æthelweard	этельвард
ludger	людгер
eusébio	эйсебио
kiko	кико
capucho	капушу
takeshi	такэси
guntram	гунтрамн
humfrid	гумфрид
schmid	шмид
lydus	лид
sykes	сайкс
germanicus	германик
thrasyllus	фрасилл
aureolus	авреол
konstantinos	константинос
hamengkubuwono	хаменгкубувоно
holly	холли
andocides	андокид
aleš	алеш
fuzûlî	физули
titian	тициан
udo	удо
ethel	этель
callippus	каллипп
gundoald	гундовальд
appian	аппиан
mehdi	мехди
petter	петтер
riphath	рифат
hilderic	хильдерих
vitalian	виталиан
branislav	бранислав
adalgis	адельхиз
lawson	лоусон
dida	дида
gianluca	джанлука
ana	ана
lina	лина
armin	армин
camillo	камилло
rick	рик
lorenz	лоренц
ioannis	иоаннис
yuan	юань
amy	эми
omar	омар
chase	чейз
ray	рэй
brandt	брандт
vargas	варгас
pekka	пекка
hannu	ханну
henri	анри
kārlis	карлис
mccarthy	маккарти
clara	клара
ellis	эллис
karel	карел
alfredo	альфредо
petrov	петров
lászló	ласло
moreira	морейра
clayton	клейтон
lola	лола
forrest	форрест
shelley	шелли
thierry	тьерри
nikita	никита
baker	бейкер
carlos	карлос
bernardo	бернардо
mara	мара
esther	эстер
benítez	бенитес
guerrero	герреро
dragutin	драгутин
farina	фарина
radek	радек
mieczysław	мечислав
enzo	энцо
gregorio	грегорио
robson	робсон
manning	мэннинг
mortensen	мортенсен
joe	джо
madison	мэдисон
adolfo	адольфо
martin	мартин
jordan	джордан
linda	линда
brown	браун
olaf	олаф
kerry	керри
matija	матия
daisuke	дайсукэ
adnan	аднан
yamashita	ямасита
lasse	лассе
emiliano	эмилиано
franjo	франьо
nikos	никос
yoshida	ёсида
emery	эмери
giordano	джордано
feng	фэн
miodrag	миодраг
yamamoto	ямамото
vallejo	вальехо
gavin	гэвин
panagiotis	панайотис
janko	янко
aya	ая
judy	джуди
marino	марино
brent	брент
florent	флоран
ye	е
dwight	дуайт
devon	девон
gianfranco	джанфранко
lennon	леннон
ladislav	ладислав
horacio	орасио
forster	форстер
magda	магда
jochen	йохен
peng	пэн
dora	дора
rasmussen	расмуссен
amber	эмбер
bellamy	беллами
savage	сэвидж
ryszard	рышард
emanuele	эмануэле
andré	андре
ernst	эрнст
thomson	томсон
kim	ким
marvin	марвин
billy	билли
mercedes	мерседес
brooks	брукс
vera	вера
arne	арне
hernández	эрнандес
francesca	франческа
marat	марат
krause	краузе
bertrand	бертран
travis	трэвис
ignacio	игнасио
wilhelm	вильгельм
cox	кокс
duff	дафф
sylvain	сильвен
galina	галина
rosenberg	розенберг
hudson	хадсон
atkinson	аткинсон
juozas	юозас
irving	ирвинг
grace	грейс
jacqueline	жаклин
o	о
lynn	линн
gutiérrez	гутьеррес
joaquín	хоакин
kazuo	кадзуо
lothar	лотар
agnieszka	агнешка
nilsson	нильссон
donovan	донован
fu	фу
morales	моралес
danilo	данило
moreno	морено
müller	мюллер
jaan	яан
søren	сёрен
leighton	лейтон
dumont	дюмон
otis	отис
hicks	хикс
delgado	дельгадо
della	делла
tucker	такер
georg	георг
jacques	жак
osman	осман
holt	холт
ken	кен
manuela	мануэла
randy	рэнди
lena	лена
guido	гвидо
lincoln	линкольн
montgomery	монтгомери
ulf	ульф
brock	брок
melvin	мелвин
jukka	юкка
schmitt	шмитт
ai	ай
baruch	барух
caro	каро
sánchez	санчес
wilkins	уилкинс
kingsley	кингсли
cody	коди
dallas	даллас
sargent	сарджент
dickinson	дикинсон
mary	мэри
kenneth	кеннет
ruth	рут
moses	мозес
marcelo	марсело
lorenzo	лоренцо
wilson	уилсон
trent	трент
jayavarman	джаяварман
cornell	корнелл
kidd	кидд
ivana	ивана
larionov	ларионов
watanabe	ватанабэ
otakar	отакар
arellano	арельяно
sebastiano	себастьяно
gold	голд
foster	фостер
yutaka	ютака
evan	эван
antonelli	антонелли
honda	хонда
hiroki	хироки
cindy	синди
juliusz	юлиуш
marsh	марш
ricci	риччи
benno	бенно
janet	джанет
elvis	элвис
reyes	рейес
andrija	андрия
yamada	ямада
dexter	декстер
bridges	бриджес
takeo	такэо
waters	уотерс
rafał	рафал
tyson	тайсон
aoki	аоки
tiffany	тиффани
shen	шэнь
bright	брайт
fields	филдс
kirsten	кирстен
spence	спенс
sabrina	сабрина
best	бест
gruber	грубер
berlin	берлин
matsumoto	мацумото
archie	арчи
melissa	мелисса
potter	поттер
debbie	дебби
valentino	валентино
shigeru	сигэру
greenwood	гринвуд
hodgson	ходжсон
severino	северино
andrás	андраш
nazarov	назаров
jørgensen	йоргенсен
christos	христос
griffiths	гриффитс
gonzález	гонсалес
cabrera	кабрера
fletcher	флетчер
hope	хоуп
pérez	перес
siegfried	зигфрид
nino	нино
robert	роберт
rubinstein	рубинштейн
françoise	франсуаза
rossi	росси
johann	иоганн
gabriel	габриэль
webb	уэбб
stanley	стэнли
clive	клайв
kurt	курт
varela	варела
watson	уотсон
calderón	кальдерон
burke	бёрк
miroslav	мирослав
henry	генри
jimmy	джимми
suárez	суарес
vieira	виейра
rodrigo	родриго
fabre	фабр
serra	серра
davidson	дэвидсон
manfred	манфред
ismail	исмаил
torres	торрес
morris	моррис
fredrik	фредрик
werner	вернер
thompson	томпсон
nur	нур
martens	мартенс
julien	жюльен
ferdinando	фердинандо
domínguez	домингес
abel	абель
dudley	дадли
brandon	брэндон
jiang	цзян
aslan	аслан
hal	хэл
gibbons	гиббонс
brittany	бриттани
larsen	ларсен
jake	джейк
bernardino	бернардино
mirko	мирко
hopkins	хопкинс
frankie	фрэнки
fan	фань
navarro	наварро
birgit	биргит
glover	гловер
anja	аня
ellen	эллен
anthony	энтони
hutton	хаттон
benjamin	бенджамин
ercole	эрколе
lynch	линч
compton	комптон
ma	ма
sutherland	сазерленд
gates	гейтс
katz	кац
leonardo	леонардо
zimmermann	циммерман
justus	юстус
smirnov	смирнов
pat	пэт
de	де
józef	юзеф
jean	жан
evert	эверт
peretz	перец
frost	фрост
odd	одд
clyde	клайд
perrin	перрен
bartlett	бартлетт
ottavio	оттавио
roque	роке
massey	мэсси
zalman	залман
hilton	хилтон
booth	бут
hammer	хаммер
olson	олсон
morel	морель
darryl	дэррил
rinpoche	ринпоче
ter	тер
mona	мона
shepard	шепард
costello	костелло
heikki	хейкки
sigurd	сигурд
ida	ида
stanton	стэнтон
nixon	никсон
sweeney	суини
hull	халл
ludwig	людвиг
mauricio	маурисио
luciano	лучано
françois	франсуа
pablo	пабло
ferguson	фергюсон
sharif	шариф
dillon	диллон
larsson	ларссон
milton	милтон
charlie	чарли
jerome	джером
danny	дэнни
auguste	огюст
stefano	стефано
minoru	минору
marini	марини
chelsea	челси
kovačević	ковачевич
faber	фабер
okamoto	окамото
weaver	уивер
katarzyna	катажина
aryeh	арье
hideyuki	хидэюки
jussi	юсси
silvio	сильвио
evaristo	эваристо
bishop	бишоп
giancarlo	джанкарло
garner	гарнер
serena	серена
kasper	каспер
dražen	дражен
crane	крейн
guglielmo	гульельмо
satoshi	сатоси
henk	хенк
mansfield	мэнсфилд
kálmán	кальман
mira	мира
ada	ада
amano	амано
gökhan	гёкхан
fink	финк
tsutomu	цутому
buddy	бадди
irena	ирена
gabriela	габриэла
tina	тина
freire	фрейре
alessio	алессио
minami	минами
les	лес
ariel	ариэль
jackie	джеки
len	лен
mussolini	муссолини
carrie	кэрри
gustafsson	густафссон
hideki	хидэки
kikuchi	кикути
cannon	кэннон
aki	аки
edoardo	эдоардо
shaw	шоу
gillian	джиллиан
judd	джадд
mclaren	макларен
linden	линден
thanh	тхань
areobindus	ареобинд
edna	эдна
oldřich	олдржих
tullio	туллио
rooney	руни
woods	вудс
riva	рива
heath	хит
lively	лайвли
bent	бент
fiedler	фидлер
ondřej	ондржей
kimura	кимура
carly	карли
gemma	джемма
camus	камю
tokugawa	токугава
ackermann	аккерман
shalom	шалом
leonidas	леонидас
masaru	масару
patton	паттон
bondarenko	бондаренко
glass	гласс
chiara	кьяра
rush	раш
benton	бентон
katja	катя
alexa	алекса
campos	кампос
juan	хуан
moritz	мориц
leandro	леандро
friedrich	фридрих
ted	тед
harold	гарольд
randolph	рэндольф
sextus	секст
morrow	морроу
browning	браунинг
vivian	вивиан
holmes	холмс
richards	ричардс
rivera	ривера
sally	салли
romuald	ромуальд
august	август
price	прайс
leonard	леонард
tiberius	тиберий
pierre	пьер
wade	уэйд
emerson	эмерсон
holland	холланд
popov	попов
robin	робин
horton	хортон
alexandra	александра
georgia	джорджия
greenberg	гринберг
aimé	эме
hunt	хант
khan	хан
adams	адамс
hilarion	иларион
romano	романо
gideon	гидеон
hardy	харди
romero	ромеро
helen	хелен
jared	джаред
todor	тодор
jefferson	джефферсон
grimm	гримм
gerd	герд
parsons	парсонс
weber	вебер
johnny	джонни
klaus	клаус
austin	остин
bonnie	бонни
tkachenko	ткаченко
love	лав
marley	марли
eldar	эльдар
vsevolod	всеволод
troy	трой
gianni	джанни
natasha	наташа
blanco	бланко
agostino	агостино
ulrich	ульрих
ortiz	ортис
mikko	микко
mel	мел
károly	карой
watkins	уоткинс
papadopoulos	пападопулос
ferdinand	фердинанд
barry	барри
fernando	фернандо
guillaume	гийом
gyula	дьюла
gerald	джеральд
marshall	маршалл
clarence	кларенс
he	хэ
shah	шах
berger	бергер
medina	медина
pereira	перейра
antonia	антония
black	блэк
wilder	уайлдер
cleveland	кливленд
caldwell	колдуэлл
landau	ландау
gore	гор
guevara	гевара
everett	эверетт
bahram	бахрам
roderick	родерик
taras	тарас
giulio	джулио
bert	берт
wilfred	уилфред
birger	биргер
henderson	хендерсон
gunn	ганн
delaunay	делоне
manuel	мануэль
lucius	луций
ahmet	ахмет
augusto	аугусто
álvarez	альварес
ilya	илья
branko	бранко
orlando	орландо
jan	ян
sandro	сандро
georges	жорж
jing	цзин
alison	элисон
marcos	маркос
eduardo	эдуардо
burns	бёрнс
mats	матс
zvonimir	звонимир
rice	райс
donaldson	дональдсон
barber	барбер
vito	вито
lombardo	ломбардо
aris	арис
hogan	хоган
zdravko	здравко
oda	ода
barney	барни
balfour	бальфур
landon	лэндон
gibbs	гиббс
sigurðsson	сигурдссон
estelle	эстель
mo	мо
zapata	сапата
gardiner	гардинер
hannes	ханнес
watts	уоттс
amedeo	амедео
duhamel	дюамель
parkinson	паркинсон
sverre	сверре
hilary	хилари
finn	финн
goldsmith	голдсмит
acevedo	асеведо
smart	смарт
ned	нед
amar	амар
fiona	фиона
iversen	иверсен
per	пер
wyatt	уайетт
molina	молина
seleucus	селевк
eaton	итон
maximilian	максимилиан
valdés	вальдес
héctor	эктор
edmond	эдмон
alfonso	альфонсо
wallace	уоллес
enver	энвер
tomislav	томислав
sharma	шарма
clément	клеман
jovanović	йованович
floyd	флойд
haas	хаас
leopold	леопольд
nathaniel	натаниэль
visconti	висконти
vogel	фогель
louis	луи
jerry	джерри
muñoz	муньос
murphy	мёрфи
arthur	артур
dolores	долорес
skinner	скиннер
church	чёрч
greer	грир
hodges	ходжес
melville	мелвилл
ilan	илан
osamu	осаму
milošević	милошевич
kazys	казис
sani	сани
sturm	штурм
mustafa	мустафа
xiang	сян
hippocrates	гиппократ
empress	императрица
cáceres	касерес
kai	кай
nakano	накано
presley	пресли
zsolt	жолт
roussel	руссель
ewald	эвальд
németh	немет
hopper	хоппер
dylan	дилан
morita	морита
yair	яир
pino	пино
harrington	харрингтон
loïc	лоик
masashi	масаси
romain	ромен
valerio	валерио
tara	тара
cherry	черри
maeda	маэда
celia	селия
akiko	акико
darling	дарлинг
mcqueen	маккуин
march	марч
garibald	гарибальд
vlado	владо
wells	уэллс
facundo	факундо
albright	олбрайт
monroe	монро
thutmose	тутмос
kalevi	калеви
takeda	такэда
pike	пайк
bastian	бастиан
kwame	кваме
dragoljub	драголюб
prasad	прасад
raquel	ракель
moser	мозер
amnon	амнон
betsy	бетси
malone	мэлоун
erasmus	эразм
namgyal	намгьял
masahiro	масахиро
jesper	йеспер
dyer	дайер
scarlett	скарлетт
farmer	фармер
györgy	дьёрдь
iman	иман
pollock	поллок
snyder	снайдер
stanford	стэнфорд
wall	уолл
mao	мао
leoni	леони
zvi	цви
alla	алла
gareth	гарет
darcy	дарси
cassidy	кэссиди
colombo	коломбо
candice	кэндис
petri	петри
eriksen	эриксен
hanno	ханно
emmerich	эммерих
leone	леоне
guan	гуань
naoki	наоки
dai	дай
child	чайлд
quentin	квентин
trump	трамп
nguyen	нгуен
lowell	лоуэлл
marilyn	мэрилин
elio	элио
summers	саммерс
chalmers	чалмерс
yılmaz	йылмаз
peck	пек
bohumil	богумил
esposito	эспозито
seth	сет
pelletier	пеллетье
das	дас
prieto	прието
shinji	синдзи
gotō	гото
braga	брага
poul	поуль
ognjen	огнен
powers	пауэрс
borislav	борислав
peder	педер
tennant	теннант
sasaki	сасаки
dempsey	демпси
lindgren	линдгрен
vuk	вук
endre	эндре
davenport	дэвенпорт
qian	цянь
vilém	вилем
shlomo	шломо
huntington	хантингтон
buckley	бакли
junichi	дзюнъити
vyacheslav	вячеслав
armen	армен
hasegawa	хасэгава
corrado	коррадо
auerbach	ауэрбах
eulogius	евлогий
olli	олли
zhen	чжэнь
redgrave	редгрейв
yasuhiro	ясухиро
rosen	розен
wirth	вирт
lois	лоис
xue	сюэ
carrera	каррера
maurer	маурер
bao	бао
greta	грета
star	стар
boško	бошко
zlatko	златко
yoshio	ёсио
orozco	ороско
clarkson	кларксон
italo	итало
eero	ээро
christiansen	кристиансен
margit	маргит
michelangelo	микеланджело
mcgrath	макграт
jia	цзя
ryder	райдер
agnelli	аньелли
megumi	мэгуми
gracie	грейси
mateusz	матеуш
tate	тейт
kelly	келли
emmanuel	эммануэль
karim	карим
berman	берман
franklin	франклин
fred	фред
franz	франц
lange	ланге
barbosa	барбоза
gilles	жиль
ferrara	феррара
yaakov	яаков
vasile	василе
graham	грэм
antiochus	антиох
emily	эмили
leopoldo	леопольдо
inna	инна
roosevelt	рузвельт
berthold	бертольд
claude	клод
van	ван
jennings	дженнингс
mia	миа
clemens	клеменс
nash	нэш
antti	антти
hervé	эрве
carson	карсон
lana	лана
higgins	хиггинс
rose	роуз
painter	вазописец
n	н
vadim	вадим
bravo	браво
lancaster	ланкастер
girard	жирар
benito	бенито
jarvis	джарвис
mariana	мариана
gleb	глеб
valentin	валентин
al	аль
rachel	рэйчел
becker	беккер
leslie	лесли
carr	карр
ramírez	рамирес
simmons	симмонс
honoré	оноре
fanny	фанни
emanuel	эмануэль
fernández	фернандес
rauf	рауф
cao	цао
terrence	терренс
zheng	чжэн
ville	вилле
devi	деви
connie	конни
kendall	кендалл
ratibor	ратибор
lott	лотт
köhler	кёлер
ferrer	феррер
saarinen	сааринен
field	филд
nikolaos	николаос
teixeira	тейшейра
rolando	роландо
schumacher	шумахер
luce	люс
townsend	таунсенд
svensson	свенссон
harper	харпер
ezequiel	эсекьель
york	йорк
d	д
turner	тёрнер
karol	кароль
wanda	ванда
roy	рой
ptolemy	птолемей
freeman	фримен
lópez	лопес
heinrich	генрих
anna	анна
jorge	хорхе
pasha	паша
bob	боб
randall	рэндалл
norberto	норберто
naum	наум
strong	стронг
judge	джадж
blair	блэр
zara	зара
schlesinger	шлезингер
duarte	дуарте
donner	доннер
cecil	сесил
marr	марр
helge	хельге
parra	парра
godwin	годвин
ilona	илона
carver	карвер
bengt	бенгт
gough	гоф
acosta	акоста
eino	эйно
rudolf	рудольф
victoria	виктория
ivanovich	иванович
ole	оле
starr	старр
giovanni	джованни
rich	рич
nana	нана
wu	у
františek	франтишек
don	дон
seymour	сеймур
courtney	кортни
newman	ньюман
magnus	магнус
javad	джавад
edgardo	эдгардо
ruby	руби
jansson	янссон
chao	чао
stubbs	стаббс
strabo	страбон
benedetti	бенедетти
vasilis	василис
marit	марит
marcellinus	марцеллин
galli	галли
robles	роблес
ziegler	циглер
aulus	авл
goodwin	гудвин
dyson	дайсон
mullen	маллен
newell	ньюэлл
innes	иннес
sorel	сорель
giovanna	джованна
casanova	казанова
north	норт
ilie	илие
warner	уорнер
harding	хардинг
adi	ади
ott	отт
barlow	барлоу
svetozar	светозар
masako	масако
glyn	глин
serrano	серрано
shelton	шелтон
liz	лиз
valdis	валдис
rowley	роули
dolan	долан
whitehead	уайтхед
farley	фарли
ferrero	ферреро
mateo	матео
morley	морли
guilherme	гильерме
motta	мотта
dietmar	дитмар
ventura	вентура
brandão	брандао
bellini	беллини
finch	финч
pavol	павол
kelsey	келси
wessel	вессель
bartholomew	бартоломью
merkel	меркель
aldridge	олдридж
gintaras	гинтарас
peyton	пейтон
kid	кид
fleming	флеминг
waldemar	вальдемар
flavius	флавий
habib	хабиб
wolfram	вольфрам
fielding	филдинг
jenny	дженни
sullivan	салливан
ferreira	феррейра
andrews	эндрюс
jensen	йенсен
jürgen	юрген
erwin	эрвин
miguel	мигель
balthasar	бальтазар
santana	сантана
felipe	фелипе
baba	баба
levon	левон
iglesias	иглесиас
mir	мир
carla	карла
bartosz	бартош
archer	арчер
norton	нортон
hagen	хаген
stafford	стаффорд
mathieu	матьё
alphonse	альфонс
anastasia	анастасия
nicolae	николае
carol	кэрол
bo	бо
angelo	анджело
harry	гарри
willem	виллем
richard	ричард
beat	беат
igarashi	игараси
uroš	урош
juho	юхо
bode	боде
fukuda	фукуда
firmus	фирм
crosby	кросби
juvenalis	ювеналий
alessandra	алессандра
sakata	саката
petre	петре
yamaguchi	ямагути
ishikawa	исикава
pardo	пардо
andrius	андрюс
mylène	милен
connolly	коннолли
penny	пенни
masao	масао
hajime	хадзимэ
ibarra	ибарра
dodd	додд
fujita	фудзита
tucci	туччи
johansen	йохансен
natsuki	нацуки
paddy	пэдди
elia	элиа
brontë	бронте
mildred	милдред
pfister	пфистер
aguilar	агилар
tamás	тамаш
masaki	масаки
célestin	селестен
britton	бриттон
phoenix	феникс
coppola	коппола
lombardi	ломбарди
artabasdos	артавазд
katayama	катаяма
biro	биро
donati	донати
eriksson	эрикссон
egil	эгиль
raabe	раабе
schell	шелл
sakai	сакаи
obradović	обрадович
kemal	кемаль
britt	бритт
maron	марон
hoppe	хоппе
cope	коуп
pilar	пилар
josie	джози
haris	харис
underwood	андервуд
gratian	грациан
ertl	эртль
sugiyama	сугияма
marjorie	марджори
duško	душко
dalla	далла
lyndon	линдон
adriana	адриана
cimon	кимон
hitomi	хитоми
baur	баур
vinson	винсон
melinda	мелинда
shay	шей
tobin	тобин
antonis	антонис
handler	хэндлер
pisano	пизано
miloslav	милослав
đorđević	джорджевич
hannibal	ганнибал
marlon	марлон
almond	алмонд
dewey	дьюи
jermaine	джермейн
tapio	тапио
antun	антун
eyal	эяль
hooper	хупер
stevan	стеван
toshiro	тосиро
gerasimov	герасимов
monk	монк
crespo	креспо
ram	рам
dov	дов
bourgeois	буржуа
svoboda	свобода
jindřich	йиндржих
lala	лала
krzysztof	кшиштоф
pelé	пеле
håkan	хокан
szczęsny	щенсный
hideo	хидэо
yukio	юкио
kojima	кодзима
ferreri	феррери
sonny	сонни
ueda	уэда
magomed	магомед
yoshihiro	ёсихиро
remo	ремо
ba	ба
corneliu	корнелиу
camacho	камачо
savić	савич
baiju	байджу
werth	верт
pastrana	пастрана
arana	арана
veneziano	венециано
marić	марич
merle	мерл
zane	зейн
hancock	хэнкок
tarasov	тарасов
yuichi	юити
phyllis	филлис
lamberto	ламберто
bergen	берген
kluger	клугер
nakayama	накаяма
mccoy	маккой
kati	кати
ginger	джинджер
apel	апель
abdoulaye	абдулай
kawashima	кавасима
corinna	коринна
kiplagat	киплагат
hoshino	хосино
tammy	тэмми
hua	хуа
emmy	эмми
marisa	мариса
bud	бад
erkki	эркки
willibald	виллибальд
zé	зе
sparks	спаркс
villalobos	вильялобос
flemming	флемминг
damiano	дамиано
lino	лино
boban	бобан
mccartney	маккартни
lux	люкс
iris	айрис
thiago	тиаго
loretta	лоретта
swift	свифт
masayuki	масаюки
herta	герта
eitan	эйтан
woody	вуди
arlen	арлен
tao	тао
brunet	брюне
dariusz	дариуш
arquette	аркетт
jade	джейд
maximian	максимиан
maciej	мацей
morena	морена
fomin	фомин
mefodiy	мефодий
massimiliano	массимилиано
helms	хелмс
ashton	эштон
gal	галь
zeng	цзэн
whitaker	уитакер
çetin	четин
lykourgos	ликург
christensen	кристенсен
dumitrescu	думитреску
penelope	пенелопа
norma	норма
jorma	йорма
leblanc	леблан
sayaka	саяка
gheorghiu	георгиу
mcmahon	макмэхон
nacho	начо
eliezer	элиэзер
rybakov	рыбаков
flo	фло
milovan	милован
millar	миллар
clint	клинт
kowalczyk	ковальчик
xun	сюнь
gibb	гибб
emre	эмре
dorian	дориан
anand	ананд
sheila	шейла
messina	мессина
liliana	лилиана
matsui	мацуи
ulises	улисес
naoto	наото
balthild	батильда
tóth	тот
murakami	мураками
lyubov	любовь
hao	хао
ekman	экман
jenő	енё
demidov	демидов
viviani	вивиани
dirk	дирк
conti	конти
abe	абэ
benn	бенн
jarkko	яркко
tatsuya	тацуя
pinchas	пинхас
mimi	мими
merz	мерц
shalmaneser	салманасар
silver	сильвер
coates	коутс
pineda	пинеда
caleb	калеб
thomsen	томсен
mazurkiewicz	мазуркевич
pōmare	помаре
bruch	брух
vlastimil	властимил
perlman	перлман
mile	миле
ananda	ананда
biggs	биггс
hirokazu	хирокадзу
reuven	реувен
thaler	талер
gaillard	гайяр
reeve	рив
rocky	рокки
joop	йоп
mamoru	мамору
hayashi	хаяси
bertram	бертрам
zosimus	зосим
walcott	уолкотт
ocampo	окампо
hussey	хасси
seki	сэки
sepp	зепп
bailly	байи
büchel	бюхель
zborowski	зборовский
rocca	рокка
fonda	фонда
fitzpatrick	фицпатрик
aldrich	олдрич
debra	дебра
akiyama	акияма
sakamoto	сакамото
miyazaki	миядзаки
minnie	минни
hanson	хансон
benda	бенда
inger	ингер
chiba	тиба
kenichi	кэнъити
schumann	шуман
strozzi	строцци
contarini	контарини
stanković	станкович
larson	ларсон
foley	фоли
libor	либор
juha	юха
carlson	карлсон
hasler	хаслер
urs	урс
emir	эмир
kuzmin	кузьмин
espen	эспен
murad	мурад
davor	давор
benny	бенни
hampton	хэмптон
czesław	чеслав
antoine	антуан
no	но
edith	эдит
semyon	семён
curtis	кёртис
douglas	дуглас
jesse	джесси
bruno	бруно
álvaro	альваро
oleg	олег
joão	жуан
dimitrov	димитров
campbell	кэмпбелл
rodríguez	родригес
lucy	люси
taylor	тейлор
vinogradov	виноградов
long	лонг
lin	линь
forbes	форбс
churchill	черчилль
levan	леван
theodosius	феодосий
kerr	керр
sforza	сфорца
jiří	иржи
ella	элла
drew	дрю
lake	лейк
urban	урбан
niccolò	никколо
reginald	реджинальд
tristan	тристан
dimitar	димитр
krešimir	крешимир
luna	луна
cyrus	сайрус
theodora	феодора
friedman	фридман
berg	берг
timothy	тимоти
hewitt	хьюитт
richter	рихтер
kumar	кумар
potocki	потоцкий
agnes	агнес
justin	джастин
melanie	мелани
alves	алвес
mercier	мерсье
knox	нокс
chamberlain	чемберлен
pavel	павел
mehmet	мехмет
claudius	клавдий
nathan	натан
sigismund	сигизмунд
morozov	морозов
diego	диего
ap	ап
emperor	император
wilcox	уилкокс
garnier	гарнье
orlova	орлова
bedford	бедфорд
bentley	бентли
hristo	христо
villa	вилья
árpád	арпад
denise	дениз
elsa	эльза
aguirre	агирре
lauren	лорен
bowen	боуэн
domingo	доминго
václav	вацлав
ronald	рональд
charlotte	шарлотта
ricardo	рикардо
mata	мата
uwe	уве
sokolov	соколов
percy	перси
duc	дык
sima	сыма
eberhard	эберхард
leo	лео
le	ле
wolf	вольф
martínez	мартинес
yannick	янник
kaiser	кайзер
grégoire	грегуар
dustin	дастин
redmond	редмонд
moran	моран
hines	хайнс
martini	мартини
ovchinnikov	овчинников
desmond	десмонд
shearer	ширер
henson	хенсон
krishna	кришна
stan	стэн
rinaldo	ринальдо
bryant	брайант
na	на
mircea	мирча
avigdor	авигдор
toby	тоби
amelia	амелия
maciel	масиэл
sandrine	сандрин
colette	колетт
kazakov	казаков
joy	джой
marlene	марлен
junko	дзюнко
shevchuk	шевчук
gallagher	галлахер
hanley	хэнли
henning	хеннинг
renner	реннер
milorad	милорад
schubert	шуберт
reeves	ривз
timur	тимур
murray	мюррей
barthélemy	бартелеми
jeff	джефф
blaise	блез
palaiologos	палеолог
gilbert	гилберт
daphne	дафна
cotton	коттон
ivar	ивар
alina	алина
oppenheimer	оппенгеймер
huffman	хаффман
lon	лон
yao	яо
lebrun	лебрен
lyons	лайонс
xuan	сюань
ballard	баллард
goldschmidt	гольдшмидт
ants	антс
dorfman	дорфман
karina	карина
orr	орр
jaak	яак
justinian	юстиниан
attalus	аттал
sanford	сэнфорд
keating	китинг
margaret	маргарет
ritter	риттер
annie	энни
kuznetsov	кузнецов
dorji	дорджи
fonseca	фонсека
heinz	хайнц
radziwiłł	радзивилл
gill	гилл
jérôme	жером
lindsay	линдсей
andrés	андрес
reynolds	рейнольдс
vlad	влад
joanna	джоанна
bolton	болтон
perdiccas	пердикка
hyde	хайд
gloria	глория
nicomedes	никомед
baltasar	бальтасар
stirling	стирлинг
chaplin	чаплин
shankar	шанкар
zinaida	зинаида
borgia	борджиа
bonaparte	бонапарт
riccardo	риккардо
gillespie	гиллеспи
amos	амос
mccormack	маккормак
robbie	робби
arcesilaus	аркесилай
hitler	гитлер
barreto	баррето
karin	карин
miranda	миранда
fyodorov	фёдоров
abbas	аббас
velasco	веласко
qi	ци
wesley	уэсли
palma	пальма
cheng	чэн
betty	бетти
vakhtang	вахтанг
flanagan	флэнаган
francis	фрэнсис
antónio	антониу
walker	уокер
hippolyte	ипполит
jaroslav	ярослав
herbert	герберт
alberti	альберти
bourke	бурк
laurel	лорел
ivor	айвор
tikhon	тихон
agricola	агрикола
fabiano	фабиано
afonso	афонсу
pam	пэм
ginzburg	гинзбург
prospero	просперо
todorov	тодоров
bremer	бремер
florin	флорин
renard	ренар
legrand	легран
väinö	вяйнё
kessler	кесслер
zenon	зенон
coe	коу
márcio	марсио
taha	таха
bühler	бюлер
stoyanov	стоянов
honorius	гонорий
berenson	беренсон
paz	пас
devin	девин
bouchard	бушар
kamal	камаль
octave	октав
schiff	шифф
jaromír	яромир
harun	харун
armas	армас
guntis	гунтис
pierluigi	пьерлуиджи
raja	раджа
eusebio	эусебио
kenan	кенан
olivera	оливера
romulus	ромул
christer	кристер
dunbar	данбар
paterson	патерсон
dix	дикс
burgess	бёрджесс
eliyahu	элияху
dainis	дайнис
lewandowski	левандовский
binder	биндер
reich	райх
mars	марс
fernanda	фернанда
portillo	портильо
monaco	монако
rasmus	расмус
åke	оке
diarra	диарра
arce	арсе
godwinson	годвинсон
mato	мато
mill	милль
ronan	ронан
goswami	госвами
ender	эндер
megan	меган
kaarlo	каарло
leonor	леонор
coster	костер
boulanger	буланже
issa	исса
gwen	гвен
sigrid	сигрид
manson	мэнсон
orton	ортон
paoli	паоли
manfredi	манфреди
pontus	понтус
crispin	криспин
chiaki	тиаки
alma	альма
antoinette	антуанетта
yui	юи
cochrane	кокрейн
hermogenes	гермоген
ippolito	ипполито
knudsen	кнудсен
loris	лорис
ruffini	руффини
bonham	бонэм
petronius	петроний
owens	оуэнс
ferris	феррис
radomir	радомир
manolo	маноло
darby	дарби
dorn	дорн
victorinus	викторин
witt	витт
ruffo	руффо
agüero	агуэро
weinberg	вайнберг
ortega	ортега
kern	керн
slava	слава
sutton	саттон
alfaro	альфаро
ni	ни
abba	абба
pomponius	помпоний
wadsworth	уодсворт
alva	альва
jutta	ютта
roll	ролл
selby	селби
phelps	фелпс
ferran	ферран
melchior	мельхиор
luca	лука
vázquez	васкес
monte	монте
lawrence	лоуренс
alonso	алонсо
antoni	антоний
murdoch	мёрдок
vasil	васил
amr	амр
miron	мирон
addison	аддисон
zurab	зураб
lamy	лами
hyacinthe	гиацинт
tony	тони
markov	марков
ed	эд
stevens	стивенс
vega	вега
armand	арман
sharp	шарп
kent	кент
ursula	урсула
kemp	кемп
pacheco	пачеко
diamond	даймонд
désiré	дезире
hutchinson	хатчинсон
fleury	флёри
petersen	петерсен
barnett	барнетт
mancini	манчини
dion	дион
rustem	рустем
jansen	янсен
leroy	лерой
nielsen	нильсен
gustav	густав
bohuslav	богуслав
hamid	хамид
ernest	эрнест
miura	миура
milligan	миллиган
urmas	урмас
rusa	руса
roux	ру
hormizd	ормизд
emilia	эмилия
tipton	типтон
zelenka	зеленка
hašek	гашек
anaïs	анаис
shriver	шрайвер
kiyoshi	киёси
teuvo	теуво
shintaro	синтаро
argov	аргов
liisa	лийса
house	хаус
bülent	бюлент
eiji	эйдзи
hemingway	хемингуэй
holliday	холлидей
hikaru	хикару
hiller	хиллер
bastos	бастос
clements	клементс
nani	нани
răzvan	рэзван
scarlatti	скарлатти
gosling	гослинг
patricio	патрисио
barrera	баррера
rade	раде
ridley	ридли
atsushi	ацуси
pfeffer	пфеффер
sabatier	сабатье
yuta	юта
babcock	бэбкок
eggert	эггерт
ashot	ашот
lillian	лиллиан
polk	полк
tata	тата
skye	скай
keisha	кейша
butch	бутч
maas	маас
nakata	наката
kum	гым
bodmer	бодмер
pertti	пертти
beard	бирд
spike	спайк
broderick	бродерик
mcfadden	макфадден
barbora	барбора
fumio	фумио
gedeon	гедеон
hitoshi	хитоси
yoshiaki	ёсиаки
keegan	киган
benz	бенц
deborah	дебора
dumas	дюма
yoshimoto	ёсимото
ayew	айю
hendry	хендри
rust	руст
wise	уайз
langlois	ланглуа
trygve	трюгве
székely	секей
ingrīda	ингрида
rudenko	руденко
doughty	даути
bender	бендер
wallin	валлин
galla	галла
val	вэл
agis	агис
monaghan	монаган
honinbo	хонъимбо
cousins	казинс
kunio	кунио
koldo	кольдо
yujiulü	юйцзюлюй
traugott	трауготт
ágnes	агнеш
clancy	клэнси
couture	кутюр
walt	уолт
stockhausen	штокхаузен
lazarević	лазаревич
sutter	саттер
barkley	баркли
lombard	ломбард
purcell	пёрселл
gerda	герда
nakai	накаи
aristarkh	аристарх
clodius	клодий
elmore	элмор
okada	окада
kertész	кертес
sørensen	сёренсен
arbogast	арбогаст
waller	уоллер
furukawa	фурукава
toshio	тосио
ochoa	очоа
lohan	лохан
steffi	штеффи
ani	ани
hipólito	иполито
patterson	паттерсон
norio	норио
lekapenos	лакапин
dowd	дауд
arnaldo	арнальдо
nakajima	накадзима
qu	цюй
leif	лейф
aguilera	агилера
summer	саммер
colby	колби
frisch	фриш
parnell	парнелл
bacon	бэкон
trintignant	трентиньян
dubois	дюбуа
léger	леже
ishii	исии
ros	рос
andrus	андрус
takayuki	такаюки
logue	лог
borel	борель
brant	брант
ando	андо
duchesne	дюшен
tošić	тошич
seiji	сэйдзи
hiroaki	хироаки
qing	цин
rocco	рокко
ogata	огата
janković	янкович
kaya	кая
fulvio	фульвио
kingston	кингстон
manny	мэнни
bolívar	боливар
juliet	джульет
shirakawa	сиракава
freund	фройнд
janez	янез
todorović	тодорович
mickey	микки
lieven	ливен
nakahara	накахара
faustino	фаустино
sauer	зауэр
noguchi	ногути
arjen	арьен
rantanen	рантанен
ruggero	руджеро
longuet	лонге
hastings	гастингс
yasushi	ясуси
dlamini	дламини
edson	эдсон
annibale	аннибале
novaković	новакович
frith	фрит
jost	йост
callaghan	каллаган
hashimoto	хасимото
santamaría	сантамария
araki	араки
vedran	ведран
roxana	роксана
anke	анке
marduk	мардук
chloe	хлоя
cavalieri	кавальери
prisca	приска
gilad	гилад
teodoro	теодоро
kellogg	келлог
martti	мартти
kessel	кессель
roma	рома
masson	массон
emmett	эмметт
morosini	морозини
erna	эрна
sexton	секстон
gamarra	гамарра
yossi	йоси
kretschmer	кречмер
dobson	добсон
jurica	юрица
carrière	каррьер
ames	эймс
vela	вела
ganz	ганц
shimada	симада
dell	делл
ángeles	анхелес
ferruccio	ферруччо
indra	индра
hendricks	хендрикс
benita	бенита
riera	риера
nodar	нодар
masterson	мастерсон
jasper	джаспер
azevedo	азеведу
ezra	эзра
cvetković	цветкович
gifford	гиффорд
gaël	гаэль
ewing	юинг
tomoko	томоко
dvořák	дворжак
brahe	браге
peković	пекович
negri	негри
böhme	бёме
nagel	нагель
selena	селена
krišjānis	кришьянис
tadashi	тадаси
hosokawa	хосокава
kazuyoshi	кадзуёси
vitale	витале
grimaldi	гримальди
degen	деген
toivonen	тойвонен
colvin	колвин
contreras	контрерас
sastre	састре
duda	дуда
broadbent	бродбент
arndt	арндт
agostini	агостини
kendrick	кендрик
kateřina	катержина
solon	солон
segundo	сегундо
manu	ману
johnsen	йонсен
deschanel	дешанель
power	пауэр
attilio	аттилио
zuzana	зузана
mora	мора
raven	рэйвен
goss	госс
liviu	ливиу
mikel	микель
yōsuke	ёсукэ
head	хэд
sedgwick	седжвик
kalle	калле
noriega	норьега
cave	кейв
lorne	лорн
vance	вэнс
cartwright	картрайт
poll	полл
siiri	сийри
freud	фрейд
brasseur	брассёр
zeman	земан
marchetti	маркетти
ennis	эннис
gorō	горо
gojko	гойко
hideaki	хидэаки
marika	марика
menno	менно
lakshmi	лакшми
mitra	митра
bodo	бодо
babić	бабич
oktay	октай
zdzisław	здзислав
graziani	грациани
keaton	китон
tarō	таро
hoff	хофф
chanel	шанель
placido	плачидо
lucrezia	лукреция
foreman	форман
kittel	киттель
ciprian	чиприан
heiko	хайко
missy	мисси
greco	греко
jaakko	яакко
neher	неер
drago	драго
castelli	кастелли
ilkka	илкка
donnie	донни
pere	пере
coyle	койл
longo	лонго
daryl	дэрил
depardieu	депардьё
spada	спада
nobuo	нобуо
favre	фавр
roach	роуч
cristiano	кристиано
babbitt	бэббитт
dzintars	дзинтарс
smithson	смитсон
magne	магне
oren	орен
caruso	карузо
eiko	эйко
lucia	лючия
vujović	вуйович
federica	федерика
živko	живко
leakey	лики
carré	карре
chlothar	хлотарь
tsuchiya	цутия
vojislav	воислав
oppenheim	оппенгейм
lockwood	локвуд
salonen	салонен
hug	хуг
cassandra	кассандра
nara	нара
dries	дрис
litvinov	литвинов
satoru	сатору
gentile	джентиле
draper	дрейпер
carles	карлес
cosmin	космин
jojo	джоджо
mi	ми
ikeda	икэда
tōru	тору
jónsson	йоунссон
butt	батт
masakazu	масакадзу
asano	асано
aimo	аймо
eumenes	эвмен
ichirō	итиро
abigail	эбигейл
tomita	томита
uzi	узи
waltz	вальц
pavle	павле
jelinek	йелинек
connelly	коннелли
thayer	тайер
bettina	беттина
candy	кэнди
hrvoje	хрвое
giacometti	джакометти
ilmari	илмари
zlatan	златан
juliette	жюльетта
henley	хенли
zhi	чжи
theodoros	теодорос
yukari	юкари
šťastný	штястный
renzo	ренцо
aura	аура
nándor	нандор
keiji	кэйдзи
errol	эррол
oates	оутс
lanner	ланнер
joël	жоэль
dudu	дуду
mitja	митя
knorr	кнорр
cash	кэш
pfaff	пфафф
stevanović	стеванович
potts	поттс
mizuno	мидзуно
fried	фрид
molinari	молинари
ishida	исида
xavi	хави
rüdiger	рюдигер
alp	алп
sutcliffe	сатклифф
fiennes	файнс
aleksić	алексич
nanni	нанни
primož	примож
fatih	фатих
hyok	хёк
mandy	мэнди
philaret	филарет
šarūnas	шарунас
pavlos	павлос
pēteris	петерис
momčilo	момчило
mensah	менса
menachem	менахем
knežević	кнежевич
mäkinen	мякинен
bradbury	брэдбери
gaon	гаон
india	индия
orhan	орхан
irons	айронс
filatov	филатов
rinchen	ринчен
deluise	делуиз
sławomir	славомир
miyamoto	миямото
slavko	славко
kardashian	кардашян
arden	арден
orazio	орацио
wes	уэс
cam	кэм
shimizu	симидзу
ojeda	охеда
kofi	кофи
brentano	брентано
witherspoon	уизерспун
burnett	бёрнетт
jakobsson	якобссон
butterfield	баттерфилд
ramona	рамона
stipe	стипе
rami	рами
krejčí	крейчи
raud	рауд
tuomas	туомас
mani	мани
ruge	руге
easton	истон
joris	йорис
ludwik	людвик
hank	хэнк
pla	пла
whelan	уилан
davy	дэви
carmelo	кармело
rankin	рэнкин
betts	беттс
zina	зина
mavromichalis	мавромихалис
jurić	юрич
briggs	бриггс
caballero	кабальеро
gaspare	гаспаре
reinhart	рейнхарт
raj	радж
živković	живкович
messner	месснер
semih	семих
böhm	бём
salvadori	сальвадори
turnbull	тернбулл
michio	митио
zweig	цвейг
mertens	мертенс
cha	чха
rauno	рауно
petzold	петцольд
fujisawa	фудзисава
gonzalo	гонсало
gladys	глэдис
arto	арто
merchant	мерчант
coelho	коэлью
whitfield	уитфилд
tomomi	томоми
goštautas	гаштольд
javanshir	джеваншир
ringo	ринго
hobart	хобарт
pettersson	петтерссон
ristić	ристич
guang	гуан
april	эйприл
dunlop	данлоп
cartier	картье
lessing	лессинг
viggo	вигго
giroux	жиру
spinks	спинкс
garibaldi	гарибальди
sandy	сэнди
ferré	ферре
naim	наим
duncan	дункан
mizuki	мидзуки
gish	гиш
weise	вайзе
tico	тику
flowers	флауэрс
mārtiņš	мартиньш
rosalie	розали
makoto	макото
risto	ристо
imogen	имоджен
michaels	майклз
vukašin	вукашин
miyazawa	миядзава
vahan	ваан
eller	эллер
grigorescu	григореску
courtois	куртуа
pavlovich	павлович
irina	ирина
mikhail	михаил
arkady	аркадий
tolstoy	толстой
estrada	эстрада
francisco	франсиско
veli	вели
bolesław	болеслав
colonna	колонна
fidel	фидель
hamilton	гамильтон
shalva	шалва
vytautas	витаутас
johnston	джонстон
severus	север
michael	майкл
jaime	хайме
kaplan	каплан
fitzgerald	фицджеральд
cummings	каммингс
cabral	кабрал
frolov	фролов
nikephoros	никифор
fyodor	фёдор
theo	тео
fuentes	фуэнтес
adhemar	адемар
fowler	фаулер
astrid	астрид
gusev	гусев
carloman	карломан
cecilia	сесилия
miriam	мириам
alik	алик
beth	бет
jesús	хесус
novikov	новиков
mills	миллс
solomon	соломон
gonzaga	гонзага
nadezhda	надежда
gheorghe	георге
angie	энджи
núñez	нуньес
welch	уэлч
borisovich	борисович
reza	реза
chapman	чепмен
bowie	боуи
shirazi	ширази
justo	хусто
petr	петр
blanche	бланш
camargo	камарго
anastasius	анастасий
vasily	василий
roberta	роберта
idris	идрис
lyon	лайон
nuri	нури
willard	уиллард
bernstein	бернштейн
mariam	мариам
padilla	падилья
georgios	георгиос
kershaw	кершоу
jiménez	хименес
job	иов
yusuf	юсуф
kate	кейт
johansson	юханссон
ignaz	игнац
jacobi	якоби
uri	ури
tudhaliya	тудхалия
denisov	денисов
ibragimov	ибрагимов
lacroix	лакруа
ari	ари
musa	муса
toussaint	туссен
xiao	сяо
könig	кёниг
holman	холман
ha	ха
irakli	ираклий
michel	мишель
mori	мори
albrecht	альбрехт
henriette	генриетта
sultan	султан
stepanov	степанов
heller	хеллер
janssen	янссен
ignacy	игнацы
evelyn	эвелин
heather	хизер
may	мэй
adalbert	адальберт
horn	хорн
chávez	чавес
piper	пайпер
aitken	эйткен
lerner	лернер
palacio	паласио
gross	гросс
winston	уинстон
cassini	кассини
petit	пети
sheikh	шейх
fernand	фернан
berenice	береника
boyce	бойс
moss	мосс
brunner	бруннер
elmar	эльмар
eudokia	евдокия
escobar	эскобар
canning	каннинг
clemente	клементе
ilyas	ильяс
dumitru	думитру
petras	пятрас
arias	ариас
bret	брет
mortimer	мортимер
poulsen	поульсен
kirill	кирилл
pius	пий
herrera	эррера
lebedev	лебедев
stefania	стефания
cécile	сесиль
flores	флорес
rogers	роджерс
madeleine	мадлен
osborne	осборн
anwar	анвар
lima	лима
étienne	этьен
adolf	адольф
howell	хауэлл
margareta	маргарета
vincas	винцас
moody	муди
participazio	партечипацио
gallo	галло
probus	проб
ouédraogo	уэдраого
cabañas	кабаньяс
manius	маний
galeazzo	галеаццо
carmichael	кармайкл
golden	голден
mireille	мирей
cosimo	козимо
grenier	гренье
hooker	хукер
woodward	вудворд
cortés	кортес
eileen	айлин
scholz	шольц
gage	гейдж
mclean	маклин
boone	бун
michalis	михалис
herschel	гершель
damjan	дамьян
bermúdez	бермудес
ehud	эхуд
maitland	мейтленд
amado	амадо
myron	майрон
harlan	харлан
orsini	орсини
giorgio	джорджо
lear	лир
riedel	ридель
sandoval	сандоваль
guadalupe	гуадалупе
deville	девиль
schuster	шустер
villanueva	вильянуэва
galindo	галиндо
hernando	эрнандо
zhukov	жуков
palermo	палермо
yue	юэ
guerra	герра
steffen	штеффен
merrill	меррилл
roemer	рёмер
stevenson	стивенсон
prévost	прево
nicholson	николсон
bieler	билер
kurz	курц
alvarado	альварадо
pavlov	павлов
campo	кампо
marchand	маршан
madden	мэдден
pizarro	писарро
lavinia	лавиния
ernie	эрни
tshering	церинг
galen	гален
szabó	сабо
yoav	йоав
saavedra	сааведра
aram	арам
palm	пальм
nate	нейт
hale	хейл
mina	мина
kraus	краус
colbert	кольбер
savary	савари
buchanan	бьюкенен
bertha	берта
knight	найт
jakub	якуб
ilyich	ильич
epstein	эпштейн
judith	джудит
bogdan	богдан
brian	брайан
nora	нора
julius	юлиус
prosper	проспер
horace	хорас
jurgis	юргис
rufinus	руфин
bruni	бруни
wen	вэнь
sinan	синан
akiva	акива
desai	десаи
garnett	гарнетт
zaza	заза
dimitris	димитрис
shevchenko	шевченко
liv	лив
sigmund	зигмунд
andranik	андраник
kress	кресс
linares	линарес
hurley	хёрли
diogenes	диоген
young	янг
scherer	шерер
joubert	жубер
damir	дамир
sorokin	сорокин
lau	лау
atanas	атанас
adil	адиль
schilling	шиллинг
chandra	чандра
hardin	хардин
maidana	майдана
yakovlev	яковлев
constantius	констанций
downing	даунинг
kitty	китти
gatti	гатти
greenfield	гринфилд
plamen	пламен
shamil	шамиль
jahangir	джахангир
soraya	сорайя
ingvar	ингвар
dean	дин
ashur	ашшур
susan	сьюзан
petty	петти
rostislav	ростислав
pedro	педро
sergio	серхио
irwin	ирвин
barton	бартон
casey	кейси
yves	ив
meyer	мейер
tikhonov	тихонов
octavius	октавиус
davison	дэвисон
makarov	макаров
parry	пэрри
torsten	торстен
nam	нам
vivien	вивьен
eisner	айснер
ödön	эдён
naftali	нафтали
reis	реис
day	дэй
gabriele	габриэле
pfeiffer	пфайффер
dmitriev	дмитриев
ernő	эрнё
january	дженьюари
daniela	даниэла
bloch	блох
agapetus	поучение
heywood	хейвуд
shapiro	шапиро
calvert	калверт
abramov	абрамов
ignatyev	игнатьев
komarov	комаров
sheen	шин
procopius	прокопий
atkins	аткинс
alf	альф
strutt	стратт
spartacus	спартак
angela	анджела
bilal	билал
igor	игорь
neville	невилл
castro	кастро
priscilla	присцилла
fraser	фрейзер
théophile	теофиль
joan	джоан
dietrich	дитрих
anicius	аниций
hurtado	уртадо
amaral	амарал
el	эль
barr	барр
wilfried	вильфрид
crowe	кроу
richmond	ричмонд
stepanovich	степанович
rojas	рохас
ralph	ральф
levin	левин
nahum	нахум
steele	стил
alexander	александр
maria	мария
louise	луиза
matthias	маттиас
cassel	кассель
petros	петрос
nova	нова
childebert	хильдеберт
aston	астон
osgood	осгуд
alberta	альберта
octavio	октавио
faure	фор
baldassare	бальдассаре
wong	вонг
charpentier	шарпантье
ehrenfried	эренфрид
matthäus	маттеус
hatcher	хэтчер
colton	колтон
elon	элон
isser	иссер
peeter	пеэтер
sherwood	шервуд
koman	коман
dun	дунь
abadie	абади
vida	вида
carmack	кармак
rzewuski	ржевуский
yin	инь
virginie	виржини
barbu	барбу
ivanova	иванова
vesna	весна
ten	тен
ríos	риос
scholasticus	схоластик
thatcher	тэтчер
batyr	батыр
filipe	филипе
montoya	монтойя
langley	лэнгли
giuliani	джулиани
wieland	виланд
capone	капоне
dagobert	дагоберт
aarne	аарне
barrios	барриос
marsha	марша
marcian	маркиан
abrahams	абрахамс
schwab	шваб
laroche	ларош
chow	чоу
diehl	диль
mcnamara	макнамара
abt	абт
raffi	раффи
proust	пруст
badri	бадри
bona	бона
cai	цай
iva	ива
leach	лич
rabah	рабах
järnefelt	ярнефельт
horatio	горацио
rosenbaum	розенбаум
giacinto	джачинто
bogdanov	богданов
zelda	зельда
dávila	давила
farrar	фаррар
rusticus	рустик
aho	ахо
thor	тор
auer	ауэр
báthory	батори
olybrius	олибрий
kuroda	курода
ibáñez	ибаньес
parr	парр
socrates	сократ
menotti	менотти
grete	грете
postumus	постум
veselin	веселин
french	френч
renan	ренан
hübner	хюбнер
klinger	клингер
isaiah	исаия
horner	хорнер
evander	эвандер
lilienthal	лилиенталь
sabri	сабри
kilian	килиан
wills	уиллс
lupu	лупу
uribe	урибе
boileau	буало
papa	папа
tõnu	тыну
oviedo	овьедо
rune	руне
irma	ирма
larkin	ларкин
swan	суон
oliva	олива
tissot	тиссо
lü	люй
case	дело
sims	симс
neruda	неруда
imelda	имельда
blanc	блан
olin	олин
rada	рада
ansari	ансари
fillmore	филлмор
estévez	эстевес
cort	корт
korir	корир
leszek	лешек
mcgee	макги
modibo	модибо
rojo	рохо
bas	бас
fodor	фодор
otero	отеро
sherwin	шервин
sagan	саган
vladas	владас
manfredini	манфредини
amenhotep	аменхотеп
violeta	виолета
getty	гетти
bastien	бастьен
kaczmarek	качмарек
godard	годар
ogden	огден
diviš	дивиш
lovett	ловетт
rivero	риверо
eggen	эгген
ebert	эберт
quesada	кесада
niyazi	ниязи
dole	доул
priit	прийт
windsor	виндзор
majid	маджид
milutin	милутин
ubaldo	убальдо
harlow	харлоу
coolidge	кулидж
norberg	норберг
arp	арп
maguire	магуайр
hough	хаф
kamo	камо
mahler	малер
dionisio	дионисио
drexler	дрекслер
kalinowski	калиновский
chadwick	чедвик
popper	поппер
guinness	гиннесс
grassi	грасси
aaltonen	аалтонен
fra	фра
constant	констан
keith	кит
alec	алек
fournier	фурнье
albert	альберт
michele	микеле
vardan	вардан
leonov	леонов
kravchenko	кравченко
abdul	абдул
fedotov	федотов
borisov	борисов
bashir	башир
julio	хулио
cassius	кассий
renata	рената
kirk	кирк
bernhard	бернхард
edward	эдвард
pons	понс
yuri	юрий
vladimirovich	владимирович
jacopo	якопо
emin	эмин
castillo	кастильо
walid	валид
marie	мари
man	ман
horowitz	горовиц
noble	нобл
dalton	далтон
moura	моура
engelbert	энгельберт
giraud	жиро
shinya	синъя
stasys	стасис
maureen	морин
watt	уотт
berkeley	беркли
rubens	рубенс
panin	панин
polly	полли
bragg	брэгг
witte	витте
solís	солис
prescott	прескотт
molla	молла
romeo	ромео
durand	дюран
camara	камара
engel	энгель
cameron	кэмерон
lenoir	ленуар
agrippa	агриппа
benedict	бенедикт
davidovich	давидович
xavier	ксавье
semyonovich	семёнович
struve	струве
hermann	герман
josé	хосе
gottfried	готфрид
lefebvre	лефевр
aurelius	аврелий
gaston	гастон
magdalena	магдалена
archibald	арчибальд
enrique	энрике
schnabel	шнабель
álvares	альвареш
corbett	корбетт
ceaușescu	чаушеску
burian	буриан
tyszkiewicz	тышкевич
albertini	альбертини
arron	аррон
lippi	липпи
kühn	кюн
baird	бэрд
winfried	винфрид
kazuyuki	кадзуюки
six	сикс
firlej	фирлей
curci	курчи
soler	солер
aramburu	арамбуру
browder	браудер
behrens	беренс
stenbock	стенбок
weeks	уикс
lysander	лисандр
dimas	димас
noriyuki	нориюки
braulio	браулио
faliero	фальер
jie	цзе
shirō	сиро
sergiu	серджиу
zárate	сарате
kimmo	киммо
marović	марович
thiele	тиле
fermín	фермин
järvi	ярви
joss	джосс
grimes	граймс
hanke	ханке
lysias	лисий
leite	лейте
hakan	хакан
zou	цзоу
metaxas	метаксас
grimshaw	гримшоу
ježek	ежек
moschus	мосх
samson	самсон
jarno	ярно
branković	бранкович
lemm	лемм
bunny	банни
jelić	елич
mirjana	мирьяна
banda	банда
blasco	бласко
gamal	гамаль
bolaños	боланьос
calder	колдер
tello	тельо
frane	фране
toller	толлер
vujadin	вуядин
dunham	данэм
kaori	каори
boni	бони
rincón	ринкон
way	уэй
miran	миран
marcius	марций
cavalli	кавалли
zima	зима
nomura	номура
ousmane	усман
povilas	повилас
tierney	тирни
artis	артис
bibiana	бибиана
kubrat	кубрат
walpole	уолпол
tivadar	тивадар
britten	бриттен
winters	уинтерс
ivković	ивкович
gaynor	гейнор
ottmar	оттмар
mészáros	месарош
allende	альенде
grandjean	гранжан
schenck	шенк
lei	лэй
bianco	бьянко
satomi	сатоми
masaaki	масааки
savannah	саванна
kocsis	кочиш
linz	линц
eliasson	элиассон
takada	такада
baer	бэр
quilico	килико
avril	авриль
goßler	госслер
sjöberg	шёберг
noriko	норико
chieko	тиэко
ajdukiewicz	айдукевич
ozawa	одзава
reg	рег
corelli	корелли
ildefons	ильдефонс
judas	иуда
maleeva	малеева
kamiński	каминьский
holloway	холлоуэй
baines	бейнс
valverde	вальверде
kazuya	кадзуя
wyeth	уайет
belinda	белинда
schober	шобер
hobbs	хоббс
kibet	кибет
krag	краг
dupont	дюпон
kinski	кински
scola	скола
forsberg	форсберг
sinatra	синатра
link	линк
djalma	джалма
stavros	ставрос
moll	молль
milev	милев
immanuel	иммануил
baum	баум
masayoshi	масаёси
takeaki	такэаки
damo	дамо
rao	рао
nordahl	нурдаль
culkin	калкин
issei	иссэй
bílek	билек
delta	дельта
brun	брун
dimitrie	димитрие
albani	альбани
massa	масса
devlin	девлин
asakura	асакура
ulrik	ульрик
norodom	нородом
mclaughlin	маклафлин
amit	амит
solveig	сольвейг
smendes	смендес
muldoon	малдун
arrigo	арриго
mariko	марико
salgado	сальгадо
sena	сена
kvaternik	кватерник
vladan	владан
marton	мартон
karimi	карими
harker	харкер
kirkpatrick	киркпатрик
raskin	раскин
furtado	фуртадо
lippo	липпо
dao	дао
yumi	юми
esquivel	эскивель
rossiter	росситер
selma	сельма
győző	дьёзё
priest	прист
raimondi	раймонди
cullen	каллен
žydrūnas	жидрунас
dermot	дермот
naoko	наоко
yazid	язид
birch	бёрч
manos	манос
marquard	марквард
tomaž	томаж
koloman	коломан
erling	эрлинг
arad	арад
hino	хино
esau	исав
farah	фарах
dumoulin	дюмулен
takeuchi	такэути
michela	микела
jarry	жарри
kunihiko	кунихико
taglioni	тальони
naguib	нагиб
tessa	тесса
narayan	нараян
anémone	анемон
marceau	марсо
mok	мок
lund	лунд
simonetta	симонетта
radovan	радован
coltrane	колтрейн
kalla	калла
horrocks	хоррокс
damjanović	дамьянович
eckhart	экхарт
villon	вийон
nadal	надаль
pepe	пепе
joseba	хосеба
antić	антич
canales	каналес
mäkelä	мякеля
isidoro	исидоро
schwimmer	швиммер
ladd	лэдд
koskinen	коскинен
blume	блюме
doni	дони
yokoyama	ёкояма
avram	аврам
jonker	йонкер
bekele	бекеле
ilze	илзе
chance	ченс
tola	тола
hearn	хирн
krukenberg	крукенберг
arnošt	арношт
chopra	чопра
csaba	чаба
kienzl	кинцль
gardel	гардель
zsigmond	жигмонд
botha	бота
hirano	хирано
fabricio	фабрисио
perović	перович
lustig	лустиг
toshiki	тосики
mayfield	мэйфилд
haddad	хаддад
bertoni	бертони
cañete	каньете
iveta	ивета
karppinen	карппинен
stepney	степни
storm	сторм
staudinger	штаудингер
perrault	перро
paulson	полсон
nada	нада
giampiero	джампьеро
pirro	пирро
yasuda	ясуда
didi	диди
linas	линас
ducke	дукке
seton	сетон
milić	милич
conradin	конрадин
carstens	карстенс
amati	амати
friel	фрил
bischoff	бишофф
štimac	штимац
daniella	даниэлла
croce	кроче
ronconi	ронкони
plaskett	пласкетт
nyman	нюман
ledger	леджер
uematsu	уэмацу
kohl	коль
yegor	егор
ayumi	аюми
okan	окан
swain	суэйн
baresi	барези
bayezid	баязид
hoyt	хойт
angerer	ангерер
gallas	галлас
mcgovern	макговерн
ozols	озолс
vesa	веса
refik	рефик
izumi	идзуми
apion	апион
upton	аптон
rossellini	росселлини
morse	морс
cuauhtémoc	куаутемок
donato	донато
morrissey	моррисси
rockefeller	рокфеллер
pantelis	пантелис
timothée	тимоте
steinbach	штайнбах
ke	кэ
brewster	брюстер
trey	трей
ho	хо
lepage	лепаж
amenemhat	аменемхет
kana	кана
koichi	коити
herzl	герцель
slavin	славин
rezső	режё
coppi	коппи
obregón	обрегон
hinds	хайндс
statius	стаций
nef	неф
hopp	хопп
körner	кёрнер
vjekoslav	векослав
ulla	улла
katalinić	каталинич
garson	гарсон
trujillo	трухильо
spalding	сполдинг
rutherford	резерфорд
mura	мура
saori	саори
nordin	нордин
calvus	кальв
weigel	вайгель
stevo	стево
blondel	блондель
diouf	диуф
hagelin	хагелин
everton	эвертон
coleridge	кольридж
eurico	эурику
yoshinori	ёсинори
uno	уно
serafino	серафино
ramūnas	рамунас
olympia	олимпия
feliciano	фелисиано
karlheinz	карлхайнц
corneille	корнель
heitor	эйтор
hamed	хамед
drury	друри
yeghishe	егише
frobenius	фробениус
sala	сала
wilding	уайлдинг
koller	коллер
flesch	флеш
button	баттон
alpha	альфа
callinicus	каллиник
bartolucci	бартолуччи
manco	манко
cápac	капак
barbieri	барбьери
rukavina	рукавина
franka	франка
priestley	пристли
hildebrand	гильдебранд
shōhei	сёхэй
shuja	шуджа
sakurai	сакураи
farr	фарр
shusaku	сюсаку
skarsgård	скарсгорд
krunoslav	крунослав
annemarie	аннемари
voisin	вуазен
petráš	петраш
mcdonnell	макдоннелл
angulo	ангуло
taku	таку
yitzhak	ицхак
kaoru	каору
atahualpa	атауальпа
mahal	махал
amritraj	амритрадж
jyrki	юрки
lajunen	лаюнен
fanning	фэннинг
gustave	гюстав
hitchcock	хичкок
shuai	шуай
matsuoka	мацуока
doro	доро
thorpe	торп
kōichirō	коитиро
humphries	хамфрис
milutinović	милутинович
blount	блаунт
partridge	партридж
short	шорт
tempesta	темпеста
duplessis	дюплесси
đilas	джилас
chūichi	тюити
simić	симич
ren	жэнь
wiesław	веслав
sugimoto	сугимото
fehr	фер
bonnet	бонне
arditi	ардити
weller	уэллер
ueshiba	уэсиба
alessi	алесси
kabir	кабир
leto	лето
toyoda	тоёда
heiberg	хейберг
uschi	уши
padar	падар
marla	марла
dung	зунг
dirceu	дирсеу
kiefer	кифер
volker	фолькер
bento	бенту
arminius	арминий
blythe	блайт
régine	режин
declan	деклан
eliud	элиуд
petković	петкович
holmberg	хольмберг
sakharov	сахаров
branicki	браницкий
toomas	тоомас
rivlin	ривлин
valtonen	валтонен
arlt	арльт
laurus	лавр
nansen	нансен
ohara	охара
collison	коллисон
knauer	кнауер
mohsen	мохсен
lindström	линдстрём
gresley	грисли
mineiro	минейро
asamoah	асамоа
letícia	летисия
syagrius	сиагрий
agus	агус
ponce	понсе
yoshiharu	ёсихару
micha	миха
arafat	арафат
saura	саура
lautaro	лаутаро
hikmet	хикмет
porat	порат
nie	не
schenker	шенкер
holbrook	холбрук
kallio	каллио
markku	маркку
yumiko	юмико
andretti	андретти
eilhard	эйльхард
janda	янда
fleet	флит
lavin	лавин
weinstein	вайнштейн
ramiro	рамиро
iancu	янку
auld	олд
masters	мастерс
felicity	фелисити
strait	стрейт
myrdal	мюрдаль
eliseo	элисео
bedřich	бедржих
jimi	джими
reagan	рейган
mcshane	макшейн
jewel	джуэл
aumont	омон
kamm	камм
skyler	скайлер
numa	нюма
shimura	симура
antje	антье
conon	конон
rommel	роммель
liebert	либерт
ferro	ферро
shang	шан
vittoria	виттория
jokinen	йокинен
lindberg	линдберг
crompton	кромптон
parseval	парсеваль
quiroga	кирога
whiteley	уайтли
vic	вик
luque	луке
gérald	жеральд
trinidad	тринидад
goodman	гудмен
kuijken	кёйкен
otar	отар
spitzer	спитцер
zakharov	захаров
agnès	аньес
félicien	фелисьен
staunton	стонтон
lanfranc	ланфранк
yagan	яган
rudd	радд
reber	ребер
katsura	кацура
lira	лира
rogvolod	рогволод
romberg	ромберг
yakubu	якубу
jellinek	еллинек
brzozowski	бжозовский
cage	кейдж
yuriko	юрико
aubin	обен
goodall	гудолл
cloquet	клоке
reidar	рейдар
syme	сайм
yoshiko	ёсико
carrillo	каррильо
senusret	сенусерт
kipruto	кипруто
simion	симион
filipović	филипович
sadat	садат
bernabé	бернабе
pascual	паскуаль
munir	мунир
beretta	беретта
glenda	гленда
kovalenko	коваленко
masuda	масуда
kawaguchi	кавагути
dezső	дежё
pichler	пихлер
small	смолл
mcguinness	макгиннесс
albers	альберс
pellegrini	пеллегрини
zeitlin	цейтлин
lučić	лучич
andreae	андреэ
gradenigo	градениго
adad	адад
arcangelo	арканджело
tocco	токко
marwan	марван
corradini	коррадини
jans	янс
parrish	пэрриш
neuner	нойнер
takuya	такуя
anđelković	анджелкович
smedley	смедли
edgeworth	эджуорт
mcnab	макнаб
juninho	жуниньо
veljko	велько
kerwin	кервин
tõnis	тынис
fairuz	файруз
nozawa	нодзава
takagi	такаги
quietus	квиет
frederico	фредерико
kawakami	каваками
vanek	ванек
vitti	витти
benjamín	бенхамин
tiepolo	тьеполо
shamir	шамир
hamm	хэмм
crossley	кроссли
guaita	гуайта
iurie	юрие
alden	олден
mukai	мукаи
hansson	ханссон
soria	сория
haines	хейнс
grünberg	грюнберг
simonsen	симонсен
morimoto	моримото
misaki	мисаки
sanada	санада
asia	азия
filho	фильо
mateja	матея
goode	гуд
baptista	баптиста
piccolomini	пикколомини
downs	даунс
vinnie	винни
anquetil	анкетиль
manolis	манолис
zhiyi	чжии
cleombrotus	клеомброт
mcauliffe	маколифф
crivelli	кривелли
blix	бликс
lahti	лахти
hartmut	хартмут
dorival	доривал
baumbach	баумбах
maduro	мадуро
žarko	жарко
klose	клозе
lasker	ласкер
hiramatsu	хирамацу
prestes	престес
rigoberto	ригоберто
tequila	текила
kodaira	кодайра
bronson	бронсон
efron	эфрон
bosson	боссон
lobos	лобос
claudel	клодель
takemiya	такэмия
gordian	гордиан
chu	чу
radić	радич
to	то
romeu	ромеу
mago	магон
colm	колм
biagio	бьяджо
payton	пэйтон
minkowski	минковский
hermione	гермиона
strasser	штрассер
travers	трэверс
zanetti	дзанетти
qureshi	куреши
mcguire	макгуайр
pozo	посо
sikorski	сикорский
pennant	пеннант
intef	иниотеф
niebuhr	нибур
cass	касс
spurius	спурий
takamura	такамура
melina	мелина
iwasaki	ивасаки
meister	майстер
pape	пап
seeger	сигер
ennio	эннио
boleyn	болейн
nurmi	нурми
danner	даннер
hoang	хоанг
mcgill	макгилл
boss	босс
marconi	маркони
wilmot	уилмот
büchner	бюхнер
ocean	оушен
groza	гроза
leko	леко
soule	соул
isao	исао
lyman	лайман
soriano	сориано
lucky	лаки
carducci	кардуччи
flower	флауэр
masami	масами
keil	кейль
cusack	кьюсак
guthrie	гатри
solano	солано
kumi	куми
barone	бароне
lvovich	львович
rafik	рафик
menander	менандр
shepherd	шеперд
raimi	рэйми
palladino	палладино
georgina	джорджина
gerhardt	герхардт
billington	биллингтон
antisthenes	антисфен
silvano	сильвано
casati	казати
odilon	одилон
psamtik	псамметих
koivu	койву
hari	хари
lassila	лассила
kiyotaka	киётака
styles	стайлс
dvorak	дворак
barragán	барраган
tasso	тассо
jenner	дженнер
masamune	масамунэ
becerra	бесерра
bancroft	бэнкрофт
khoja	ходжа
pegg	пегг
rabe	рабе
lakatos	лакатош
nesbit	несбит
osorio	осорио
bianca	бьянка
amadeo	амадео
coulibaly	кулибали
childeric	хильдерик
mitsuru	мицуру
silvestri	сильвестри
baggio	баджо
shahi	шахи
dado	дадо
valentinian	валентиниан
gade	гаде
łukasiewicz	лукасевич
funakoshi	фунакоси
buch	бух
eri	эри
schröder	шрёдер
pender	пендер
patsy	пэтси
peled	пелед
duchamp	дюшан
chadli	шадли
roddy	родди
higgs	хиггс
callum	каллум
till	тилл
zaimis	заимис
fine	файн
klimov	климов
victoriano	викториано
horie	хориэ
posey	поузи
vlatko	влатко
clooney	клуни
gerlach	герлах
kōtoku	котоку
aida	айда
elst	эльст
mifsud	мифсуд
pejačević	пеячевич
carrington	каррингтон
doyle	дойл
károlyi	каройи
brolin	бролин
condon	кондон
ives	айвз
bernat	бернат
mátyás	матьяш
imai	имаи
winkelhock	винкельхок
bono	боно
roché	роше
kiki	кики
ionuţ	йонуц
shishkin	шишкин
hellman	хеллман
ka	ка
avendaño	авенданьо
franchi	франки
taner	танер
ferretti	ферретти
crook	крук
lenny	ленни
darin	дарин
lederer	ледерер
rubini	рубини
cotta	котта
mendelssohn	мендельсон
diodotus	диодот
borchert	борхерт
norwood	норвуд
guðmundsson	гудмундссон
dursun	дурсун
becher	бехер
aurelian	аврелиан
andoni	андони
liebknecht	либкнехт
berliner	берлинер
vítězslav	витезслав
rollin	роллен
aurélien	орельен
lundberg	лундберг
vlada	влада
sacher	захер
terje	терье
lolo	лоло
kenyon	кеньон
kantakouzenos	кантакузин
kyoko	кёко
malmström	мальмстрём
ranavalona	ранавалуна
štěpán	штепан
domingos	домингуш
nena	нена
doc	док
bartram	бартрам
hamel	хэмел
nissen	ниссен
sarduri	сардури
simović	симович
sabatini	сабатини
tillman	тиллман
farnese	фарнезе
rueda	руэда
eliot	элиот
clough	клаф
aeschines	эсхин
harada	харада
arvidsson	арвидссон
leonel	леонель
madoka	мадока
sela	села
neumeier	ноймайер
carnahan	карнахан
cowen	коуэн
blake	блейк
ronaldo	роналдо
agag	агаг
noriaki	нориаки
childs	чайлдс
hélder	элдер
hobson	гобсон
tamura	тамура
butcher	бутчер
kašpar	кашпар
byrne	бирн
ilić	илич
finney	финни
bruckner	брукнер
somers	сомерс
munk	мунк
ionel	йонел
solbakken	сольбаккен
charilaos	харилаос
kōki	коки
stoner	стоунер
koné	коне
erkin	эркин
sulzer	зульцер
vulpius	вульпиус
chandragupta	чандрагупта
brühl	брюль
harrell	харрелл
oberto	оберто
krupa	крупа
dąbrowski	домбровский
arantxa	аранча
parviz	парвиз
cissé	сиссе
seigner	сенье
rurik	рюрик
pitts	питтс
begović	бегович
navarrete	наваррете
buffet	бюффе
uchida	утида
bossi	босси
locatelli	локателли
mitsuko	мицуко
netanyahu	нетаньяху
covey	кови
lagarde	лагард
munari	мунари
nachman	нахман
pocock	покок
catalina	каталина
arius	арий
ranieri	раньери
popescu	попеску
london	лондон
hassler	хасслер
katona	катона
rodrigue	родриг
aigars	айгар
vukčević	вукчевич
caron	карон
celio	челио
sandford	сэндфорд
anssi	ансси
akio	акио
foy	фой
beverly	беверли
felton	фелтон
mead	мид
nishizawa	нисидзава
daiki	дайки
delbrück	дельбрюк
barbarigo	барбариго
samaras	самарас
ander	андер
guimard	гимар
itzik	ицик
konishi	кониси
tournier	турнье
michaelis	михаэлис
leno	лено
haley	хейли
wheeler	уилер
kassim	кассим
király	кирай
malatesta	малатеста
kidman	кидман
melody	мелоди
moretti	моретти
staal	стаал
huisheng	хуэйшэн
kawai	каваи
stanko	станко
lenski	ленски
stowe	стоу
ede	эде
keeler	килер
aino	айно
edin	эдин
grandi	гранди
diocles	диокл
kazuhiro	кадзухиро
germano	джермано
saki	саки
prada	прада
morgenstern	моргенштерн
sander	сандер
ina	ина
khamis	хамис
arūnas	арунас
yasuo	ясуо
babangida	бабангида
jupp	юпп
masahiko	масахико
rēdlihs	редлихс
tonino	тонино
wouter	ваутер
harman	харман
mcconnell	макконнелл
burney	бёрни
lisandro	лисандро
napolitano	наполитано
samvel	самвел
rabbani	раббани
henkel	хенкель
ball	болл
amorim	аморим
kazuhiko	кадзухико
nguema	нгема
vyšniauskas	вишняускас
uemura	уэмура
assmann	ассман
sheng	шэн
tadić	тадич
wojtek	войтек
apostolos	апостолос
ebbe	эббе
senna	сенна
garth	гарт
hulk	халк
ljubičić	любичич
tecumseh	текумсе
sigebert	сигиберт
penna	пенна
bjørndalen	бьёрндален
vivarini	виварини
mccloskey	макклоски
bertalan	берталан
hozumi	ходзуми
blaž	блаж
hekking	эккинг
siniša	синиша
hai	хай
yeboah	йебоа
rogge	рогге
sangay	сангай
mánes	манес
hauptmann	гауптман
tarver	тарвер
searle	сирл
bodil	бодил
stevie	стиви
livilla	ливилла
chet	чет
schleck	шлек
nobuko	нобуко
robb	робб
takács	такач
kamiya	камия
mirsad	мирсад
talib	талиб
pernilla	пернилла
mattei	маттеи
am	ам
knapp	кнапп
wunderlich	вундерлих
crvenkovski	црвенковский
penrose	пенроуз
rolandas	роландас
sampson	сэмпсон
horia	хория
berit	берит
vlasta	власта
palacios	паласиос
victorio	викторио
matić	матич
mauno	мауно
yuki	юки
dacier	дасье
kadlec	кадлец
artūras	артурас
porras	поррас
schott	шотт
joakim	йоаким
bassano	бассано
mursili	мурсили
ratko	ратко
bettencourt	беттанкур
thévenot	тевено
deon	деон
conchita	кончита
versace	версаче
chiesa	кьеза
bosman	босман
söderström	сёдерстрём
bergström	бергстрём
bushnell	бушнелл
kido	кидо
laila	лайла
ange	анж
ljubiša	любиша
euclid	евклид
sali	сали
mutō	муто
indravarman	индраварман
konarski	конарский
koyama	кояма
borg	борг
kurihara	курихара
steinitz	стейниц
tweed	твид
oz	оз
indrek	индрек
makhmalbaf	махмальбаф
arveladze	арвеладзе
gamboa	гамбоа
vagnozzi	ваньоцци
eloy	элой
delfino	дельфино
mabel	мэйбл
szabados	сабадош
gershon	гершон
botero	ботеро
yazdegerd	йездигерд
thorvald	торвальд
callimachi	каллимаки
sutermeister	зутермайстер
chopin	шопен
crispus	крисп
vangelis	вангелис
drews	древс
carracci	карраччи
hager	хагер
susie	сьюзи
lamine	ламин
cosgrove	косгроув
delvecchio	дельвеккио
qutb	кутб
feldman	фельдман
byrnes	бирнс
hardwicke	хардвик
béjart	бежар
heng	хэн
stojanović	стоянович
truong	чыонг
dujardin	дюжарден
nobuyuki	нобуюки
golan	голан
danna	данна
akinori	акинори
simrock	зимрок
niklaus	никлаус
abdelkader	абделькадер
hirsch	хирш
gervasio	хервасио
dakota	дакота
susana	сусана
gérson	жерсон
paulus	паулюс
probst	пробст
madge	мэдж
arend	аренд
gyulay	дьюлаи
folke	фольке
arnuwanda	арнуванда
shuttarna	шуттарна
suat	суат
ōtani	отани
eötvös	этвёш
criss	крисс
garofalo	гарофало
seamus	шеймас
molitor	молитор
ōkubo	окубо
moffat	моффат
ghirlandaio	гирландайо
meira	мейра
rapp	рапп
morrill	моррилл
pickford	пикфорд
shawcross	шоукросс
paisley	пейсли
jameson	джеймсон
bérénice	беренис
šimić	шимич
vanja	ваня
frankel	франкель
kling	клинг
otter	оттер
hewlett	хьюлетт
corr	корр
huss	хусс
sharkey	шарки
mikkel	миккель
strickland	стрикленд
lerman	лерман
haruka	харука
gebauer	гебауэр
masato	масато
kieft	кифт
aizawa	айдзава
nell	нелл
kenzo	кэндзо
dutt	датт
patel	патель
alekseyev	алексеев
lady	леди
finkel	финкель
jascha	яша
gaddi	гадди
albertson	альбертсон
banana	банана
huff	хафф
spottiswoode	споттисвуд
mumford	мамфорд
hatch	хэтч
astley	эстли
beckett	беккет
armani	армани
mccabe	маккейб
abril	абриль
pipes	пайпс
stefanović	стефанович
rolin	ролен
bessie	бесси
spears	спирс
sturges	стёрджес
tautvilas	товтивил
ponti	понти
bugatti	бугатти
olsson	ульссон
shoko	сёко
leckie	леки
royce	ройс
spector	спектор
gallardo	гальярдо
nehemiah	неемия
raab	рааб
kepler	кеплер
huey	хьюи
kaji	кадзи
montero	монтеро
shō	сё
lindahl	линдаль
kolbe	кольбе
mentuhotep	ментухотеп
ainārs	айнарс
hollander	холландер
goossens	гуссенс
hasse	хассе
linna	линна
olavi	олави
dreher	дреер
winslow	уинслоу
aisha	аиша
santer	сантер
marita	марита
heine	гейне
ciro	чиро
brendel	брендель
kubilius	кубилюс
mcmanus	макманус
amel	амель
amalric	амальрик
simson	симсон
marlies	марлис
keri	кери
mounier	мунье
annabella	аннабелла
stiller	стиллер
ronson	ронсон
ćosić	чосич
vitas	витас
chantal	шанталь
majewski	маевский
yuzo	юдзо
bjarne	бьярне
cassirer	кассирер
forest	форест
karp	карп
jian	цзянь
lagos	лагос
kawasaki	кавасаки
frick	фрик
popa	попа
burhan	бурхан
poppy	поппи
lech	лех
lanza	ланца
addo	аддо
dandolo	дандоло
sonam	сонам
piłsudski	пилсудский
tomi	томи
ridgway	риджуэй
stout	стаут
menzies	мензис
fats	фэтс
chin	чин
rhonda	ронда
aigner	айгнер
paulette	полетт
sauli	саули
movilă	могила
matsumura	мацумура
ales	алесь
jacquet	жаке
taddeo	таддео
clijsters	клейстерс
kiprop	кипроп
harnack	харнак
firuz	фируз
aristotle	аристотель
ness	несс
akamatsu	акамацу
mosley	мосли
warburton	уорбертон
ure	юр
saba	саба
toriyama	торияма
miyuki	миюки
elissa	элисса
kanu	кану
mayumi	маюми
bardem	бардем
gunnarsson	гуннарссон
neco	неко
bellucci	беллуччи
boateng	боатенг
brenner	бреннер
gregory	грегори
yu	юй
florence	флоренс
abdullah	абдулла
rahman	рахман
clinton	клинтон
camilla	камилла
falk	фальк
helena	хелена
leonidovich	леонидович
haller	халлер
olof	улоф
agustín	агустин
da	да
cook	кук
harrison	харрисон
lee	ли
publius	публий
eddie	эдди
lew	лью
yakovlevich	яковлевич
elliott	эллиотт
tazz	тазз
bird	бёрд
ham	хам
osip	осип
tani	тани
cornelis	корнелис
marion	марион
nagy	надь
shin	син
esterházy	эстерхази
gerontius	геронтий
antigonus	антигон
cleopatra	клеопатра
stroganov	строганов
paley	палей
ramiz	рамиз
hugues	юг
arshak	аршак
miles	майлз
malik	малик
gnaeus	гней
figueroa	фигероа
achilleus	ахиллей
healy	хили
popović	попович
khalid	халид
elias	элиас
christian	кристиан
marco	марко
asaf	асаф
eugene	юджин
naumov	наумов
islam	ислам
shota	шота
yershov	ершов
blanchard	бланшар
floris	флорис
willoughby	уиллоуби
tamaz	тамаз
nerses	нерсес
kuzma	кузьма
temple	темпл
welf	вельф
milne	милн
merab	мераб
huxley	хаксли
javid	джавид
ramón	рамон
elizabeth	элизабет
choi	чхве
said	саид
ahmed	ахмед
mason	мейсон
stephanie	стефани
lambert	ламберт
du	дю
lev	лев
kristen	кристен
gallego	гальего
alba	альба
leila	лейла
gerrit	геррит
lily	лили
marian	мариан
miki	мики
alvin	элвин
harriet	гарриет
bergman	бергман
kozlov	козлов
kovács	ковач
thorne	торн
guérin	герен
kane	кейн
ton	тон
varvara	варвара
fitz	фиц
vasilyevich	васильевич
jeanne	жанна
petar	петар
oksana	оксана
goldberg	голдберг
grossman	гроссман
jamal	джамал
spyridon	спиридон
phillip	филлип
warburg	варбург
miner	майнер
zamoyski	замойский
benoît	бенуа
elmer	элмер
pham	фам
godunov	годунов
shu	шу
bahadur	бахадур
erskine	эрскин
eugen	ойген
roland	роланд
clement	клемент
theodor	теодор
bianchi	бьянки
pahlavi	пехлеви
nepos	непот
achilles	ахиллес
mamadou	мамаду
geneviève	женевьева
erickson	эриксон
osten	остен
anthemius	антемий
aurelio	аурелио
fulk	фульк
leberecht	леберехт
wrangel	врангель
leitner	лейтнер
rim	рим
wangchuck	вангчук
kari	кари
ghulam	гулам
uspensky	успенский
curry	карри
goltz	гольц
wasserman	вассерман
keiko	кэйко
waterhouse	уотерхаус
lozano	лосано
bueno	буэно
alarcón	аларкон
hogg	хогг
lim	лим
giles	джайлз
bērziņš	берзиньш
balboa	бальбоа
chanturia	чантурия
ferry	ферри
calhoun	кэлхун
mcdermott	макдермотт
ricky	рики
annette	аннетт
martynov	мартынов
sid	сид
seung	сын
barzani	барзани
zakir	закир
sun	сунь
schäfer	шефер
hendrik	хендрик
abramovich	абрамович
quintus	квинт
anatolyevich	анатольевич
monica	моника
aziz	азиз
mikhailovich	михайлович
andreyevich	андреевич
ambroise	амбруаз
knud	кнуд
jonas	йонас
frederick	фредерик
rey	рей
marty	марти
min	мин
antonova	антонова
amina	амина
dionysius	дионисий
quincy	куинси
pearl	перл
krug	круг
lado	ладо
boyko	бойко
orbeliani	орбелиани
antonov	антонов
gerardo	херардо
huan	хуань
garfield	гарфилд
petipa	петипа
beresford	бересфорд
khachatryan	хачатрян
slim	слим
markova	маркова
semyonov	семёнов
maher	махер
leclerc	леклерк
boyle	бойл
maimon	маймон
gong	гун
pashayev	пашаев
andris	андрис
gebhard	гебхард
cousin	кузен
knowles	ноулз
rivers	риверс
inés	инес
serafim	серафим
germain	жермен
stark	старк
villeneuve	вильнёв
rubio	рубио
inge	инге
dupré	дюпре
dina	дина
lister	листер
dinh	динь
wamba	вамба
lysenko	лысенко
lenz	ленц
bosch	бош
fausto	фаусто
bondar	бондарь
wellington	веллингтон
boutros	бутрос
wegener	вегенер
nikitin	никитин
chodkiewicz	ходкевич
mozart	моцарт
andreu	андреу
ilham	ильхам
christiane	кристиана
araujo	араухо
molly	молли
bar	бар
hoover	гувер
essen	эссен
rasul	расул
calvo	кальво
octavia	октавия
stanisław	станислав
konstantinovich	константинович
yegorov	егоров
sarah	сара
ángel	анхель
sophie	софи
rhys	рис
david	дэвид
coleman	коулман
june	джун
caesar	цезарь
luther	лютер
orlov	орлов
júnior	жуниор
aliyev	алиев
nils	нильс
dolly	долли
giulietta	джульетта
korda	корда
tin	тин
hyun	хён
graves	грейвс
luz	лус
bora	бора
wallis	уоллис
paco	пако
backer	баккер
akbar	акбар
vasco	васко
huseyn	гусейн
gillen	гиллен
sture	стуре
somoza	сомоса
kurtz	куртц
eklund	эклунд
faris	фэрис
agung	агунг
yaşar	яшар
tomaszewski	томашевский
gediminas	гедиминас
lindley	линдли
tullius	туллий
berggren	берггрен
fries	фрис
detlev	детлев
valentinovich	валентинович
rie	риэ
bradford	брэдфорд
chilton	чилтон
oussama	усама
hee	хи
ami	ами
tremblay	трамбле
yūko	юко
kirchner	кирхнер
elisabetta	элизабетта
deschamps	дешан
margret	маргрет
petrus	петрус
kossak	коссак
pinheiro	пиньейру
bain	бэйн
marković	маркович
hildegard	хильдегард
stahl	шталь
antonios	антониос
betancourt	бетанкур
giambattista	джамбаттиста
dalibor	далибор
sand	санд
carradine	кэррадайн
artaxias	арташес
shoshana	шошана
charibert	хариберт
elton	элтон
lind	линд
dmitriyevich	дмитриевич
shao	шао
conor	конор
antonescu	антонеску
meadows	медоуз
dia	диа
huth	хут
stadler	штадлер
holzer	хольцер
brückner	брюкнер
bryce	брайс
ireland	айрленд
giorgos	йоргос
dusty	дасти
graziano	грациано
pio	пио
scholl	шолль
mart	март
denny	денни
fish	фиш
ģirts	гиртс
gobbi	гобби
lazarev	лазарев
eugenio	эудженио
gotthard	готхард
eugénie	эжени
čech	чех
booker	букер
carlin	карлин
kostić	костич
salim	салим
una	уна
nikolić	николич
konopka	конопка
paradis	паради
conte	конте
vorontsov	воронцов
śliwiński	сливиньский
heiner	хайнер
mackay	маккей
monier	монье
wynne	уинн
borlée	борле
wilkie	уилки
wayans	уэйанс
aquino	акино
tae	тхэ
kavanagh	кавана
rath	рат
soares	соарес
uli	ули
deutsch	дойч
tariq	тарик
abdou	абду
ertuğrul	эртогрул
olav	олав
elżbieta	эльжбета
bernoulli	бернулли
takao	такао
rea	ри
erdmann	эрдман
doré	доре
bing	бинг
arkadyevich	аркадьевич
asher	ашер
haakon	хакон
timofeyevich	тимофеевич
petrovna	петровна
burckhardt	буркхардт
dasa	даса
golovin	головин
lehtonen	лехтонен
post	пост
hearst	херст
mcbride	макбрайд
tavares	таварес
alon	алон
reggie	реджи
grigoryevich	григорьевич
morison	морисон
nicolò	николо
macfarlane	макфарлейн
faiz	фаиз
gmelin	гмелин
mocenigo	мочениго
blau	блау
lucas	лукас
mehmed	мехмед
licinius	лициний
simeon	симеон
māris	марис
fredriksson	фредрикссон
gottlieb	готлиб
erika	эрика
junius	юний
ilyin	ильин
philibert	филибер
washington	вашингтон
vasilyev	васильев
melnikov	мельников
lord	лорд
alice	элис
reinhold	рейнгольд
gennady	геннадий
rafael	рафаэль
guzmán	гусман
pitt	питт
burroughs	берроуз
hadi	хади
voronin	воронин
klein	клейн
tigran	тигран
paulo	пауло
mac	мак
dixon	диксон
di	ди
mordechai	мордехай
nikolaus	николаус
garcés	гарсес
hermias	гермий
titov	титов
duval	дюваль
wenzel	венцель
sumner	самнер
alyona	алёна
ziya	зия
pease	пиз
shifrin	шифрин
bari	бари
vazha	важа
babington	бабингтон
juliana	юлиана
arsinoe	арсиноя
posse	поссе
nicanor	никанор
kosgei	косгеи
kogan	коган
mercy	мерси
levinson	левинсон
yaropolk	ярополк
cardozo	кардосо
ustinov	устинов
collingwood	коллингвуд
moiseyev	моисеев
rosales	росалес
sviatoslav	святослав
hashim	хашим
ivaylo	ивайло
vladimirov	владимиров
jenkinson	дженкинсон
reed	рид
cherkassky	черкасский
petrenko	петренко
zaleski	залеский
diels	дильс
elnur	эльнур
yunus	юнус
razak	разак
andreyev	андреев
kapp	капп
avelar	авелар
bigelow	бигелоу
saulius	саулюс
carola	карола
abgar	абгар
abashidze	абашидзе
inga	инга
hodge	ходж
ribot	рибо
lavrov	лавров
gurgen	гурген
rusanov	русанов
kulik	кулик
sabir	сабир
hood	худ
gutman	гутман
mammad	мамед
sotomayor	сотомайор
conan	конан
krasiński	красинский
savchenko	савченко
zakaria	закария
edison	эдисон
mitrofan	митрофан
nazim	назим
bass	басс
kara	кара
cooley	кули
wiesel	визель
burman	бурман
macbeth	макбет
arriaga	арриага
franks	фрэнкс
ramazan	рамазан
elena	елена
torre	торре
joey	джоуи
władysław	владислав
dave	дэйв
rainer	райнер
baldwin	болдуин
claudia	клаудия
guru	гуру
wiśniowiecki	вишневецкий
ira	айра
salinas	салинас
soto	сото
maya	майя
luis	луис
günther	гюнтер
buck	бак
amin	амин
abu	абу
grishin	гришин
baumann	бауман
franziska	франциска
breton	бретон
rahim	рахим
amato	амато
gábor	габор
ostrovsky	островский
faustinus	фаустин
melo	мело
paola	паола
eva	ева
potapov	потапов
rustam	рустам
fyodorovich	фёдорович
hauser	хаузер
jérémy	жереми
kulikov	куликов
christie	кристи
anatole	анатоль
cornelius	корнелий
schwarz	шварц
stanislas	станислас
downey	дауни
golubev	голубев
medvedev	медведев
akhundov	ахундов
ramin	рамин
osvaldo	освальдо
kerimov	керимов
yan	янь
winkler	винклер
kostas	костас
lyudmila	людмила
mendoza	мендоса
gómez	гомес
volkov	волков
lamb	лэмб
georgievich	георгиевич
frederica	фредерика
matveyev	матвеев
nikolayevich	николаевич
lester	лестер
sant	сант
martins	мартинс
jae	джэ
philips	филипс
ramsey	рэмси
montenegro	монтенегро
simons	симонс
rockwell	рокуэлл
har	хар
tanner	таннер
christoph	кристоф
modest	модест
díaz	диас
frank	фрэнк
cho	чо
ilija	илия
yvonne	ивонн
saad	саад
adrien	адриен
chol	чхоль
chad	чед
josefa	хосефа
hélène	элен
sergeyevich	сергеевич
andronikos	андроник
marx	маркс
hlinka	глинка
larisa	лариса
mayer	майер
hugh	хью
brooke	брук
robertas	робертас
michener	миченер
oded	одед
pimenta	пимента
maslow	маслоу
fuat	фуат
rosina	розина
persson	перссон
kummer	куммер
shapira	шапира
sylvester	сильвестр
mikayil	микаил
veloso	велозу
stott	стотт
ashcroft	эшкрофт
forshaw	форшоу
kemper	кемпер
bronstein	бронштейн
atticus	аттик
pinedo	пинедо
kloss	клосс
lingpa	лингпа
ingram	ингрэм
cumming	камминг
amparo	ампаро
kluge	клюге
lopukhin	лопухин
tennyson	теннисон
concha	конча
morrell	моррелл
pessoa	песоа
elvira	эльвира
baldry	болдри
raspe	распе
runge	рунге
wakefield	уэйкфилд
rufino	руфино
osmani	османи
bernadotte	бернадот
luria	лурия
renaud	рено
akram	акрам
ildefonso	ильдефонсо
meléndez	мелендес
konstantinov	константинов
lambros	ламброс
koninck	конинк
alasdair	аласдер
savin	савин
latimer	латимер
lilian	лилиан
amon	амон
ólafur	олафур
kostov	костов
gilman	гилман
engelmann	энгельманн
paulino	паулино
kama	кама
sweet	свит
marchesi	маркези
kimhi	кимхи
sydor	сидор
bernardi	бернарди
asa	аса
toda	тода
mkhitar	мхитар
jardine	джардин
lasha	лаша
bilge	бильге
mcnaught	макнот
lemercier	лемерсье
branimir	бранимир
everest	эверест
menéndez	менендес
lundmark	лундмарк
stamitz	стамиц
orly	орли
sigvard	сигвард
mckillip	маккиллип
hershey	херши
évariste	эварист
beach	бич
cormac	кормак
schadow	шадов
kwak	квак
lafontaine	лафонтен
doi	дои
marisol	марисоль
pauker	паукер
cobb	кобб
guram	гурам
gholam	голям
marinho	мариньо
donnelly	доннелли
didymus	дидим
nicolau	николау
musgrave	масгрейв
servius	сервий
pancho	панчо
elshan	эльшан
marston	марстон
kristol	кристол
baade	бааде
hoare	хоар
benedek	бенедек
krøyer	крёйер
kader	кадер
deividas	дейвидас
woolsey	вулси
laurynas	лауринас
starling	старлинг
geir	гейр
jacobo	хакобо
allyn	эллин
kip	кип
liebmann	либман
wheelock	уилок
guidobaldo	гвидобальдо
wendland	вендланд
sawyer	сойер
fabri	фабри
both	бот
ata	ата
kozyrev	козырев
sheppard	шеппард
blunt	блант
bartolomeu	бартоломеу
natta	натта
tarr	тарр
katina	катина
korkmaz	коркмаз
northcote	норткот
tarzi	тарзи
magomedov	магомедов
asmus	асмус
simonov	симонов
curie	кюри
shastri	шастри
castiglione	кастильоне
fittipaldi	фиттипальди
lamar	ламар
eustache	эсташ
hariri	харири
taghiyev	тагиев
rena	рена
mccallum	маккаллум
sandberger	зандбергер
alakbar	алекпер
achim	ахим
bader	бадер
fouquet	фуке
xenophon	ксенофонт
edström	эдстрём
osipov	осипов
glennon	гленнон
carmona	кармона
borden	борден
genovese	дженовезе
alcides	альсидес
boucher	буше
wangyal	вангьял
salimov	салимов
svante	сванте
galbraith	гэлбрейт
ahumada	аумада
rothstein	ротштейн
ava	ава
iker	икер
hassel	хассель
haggard	хаггард
cuthbert	катберт
dreyer	дрейер
nabil	набиль
schelling	шеллинг
kirchhoff	кирхгоф
lockhart	локхарт
maternus	матерн
tarkhan	тархан
alcántara	алькантара
godoy	годой
mahony	махони
mandel	мандель
cousteau	кусто
engels	энгельс
göring	геринг
azim	азим
vasilisa	василиса
safar	сафар
tomašević	томашевич
timm	тимм
edmundo	эдмундо
rydberg	ридберг
bekir	бекир
krasny	красный
lubomirski	любомирский
thilo	тило
ince	инс
aiken	эйкен
bellows	беллоуз
turan	туран
livia	ливия
sverdrup	свердруп
echeverría	эчеверриа
lemaître	леметр
reino	рейно
fricis	фрицис
flaherty	флаэрти
thorndike	торндайк
yuval	юваль
falko	фалько
corona	корона
pentti	пентти
lytton	литтон
clifton	клифтон
landi	ланди
artsruni	арцруни
herbig	хербиг
oka	ока
lesser	лессер
pettit	петтит
rapoport	рапопорт
lipsius	липсиус
romas	ромас
meridor	меридор
hibbert	хибберт
callimachus	каллимах
ileana	илеана
naryshkin	нарышкин
aribert	ариберт
goncharov	гончаров
zita	зита
ferraris	феррарис
finer	файнер
orson	орсон
story	стори
rogério	рожерио
ghada	гада
kilpatrick	килпатрик
krasner	краснер
biermann	бирман
petkov	петков
palencia	паленсия
rosetti	розетти
yakin	якин
ewen	юэн
caicedo	кайседо
azer	азер
cappelen	каппелен
flourens	флуранс
lafont	лафон
lejeune	лежен
paulauskas	паулаускас
lampi	лампи
loy	лой
brainin	брайнин
borghese	боргезе
castrén	кастрен
yevstigneyev	евстигнеев
buxton	бакстон
alessandri	алессандри
cervantes	сервантес
blas	блас
schrader	шрадер
dziuba	дзюба
stojković	стойкович
elman	эльман
isaac	исаак
coquelin	коклен
saucedo	сауседо
hislop	хислоп
jonah	иона
windisch	виндиш
guggenheim	гуггенхайм
casas	касас
morin	морен
mako	мако
ashkenazi	ашкенази
wittgenstein	витгенштейн
bandaranaike	бандаранаике
galeano	галеано
sigitas	сигитас
trachtenberg	трахтенберг
cañizares	каньисарес
dodds	доддс
armendáriz	армендарис
simm	симм
lada	лада
yoshiki	ёсики
samuelson	самуэльсон
pál	пал
fairchild	фэйрчайлд
kandelaki	канделаки
mount	маунт
radin	радин
kowalewski	ковалевский
reiss	рейсс
bartoli	бартоли
kiselyov	киселёв
anson	энсон
binet	бине
olivares	оливарес
taher	тахер
münnich	миних
riad	риад
kopp	копп
kreutzer	крейцер
tarja	тарья
stürmer	штюрмер
shakur	шакур
ostap	остап
arab	араб
keïta	кейта
grieg	григ
poli	поли
taleb	талеб
efraín	эфраин
ashraf	ашраф
cem	джем
bronfman	бронфман
shekhar	шекхар
musso	муссо
wróblewski	врублевский
filippov	филиппов
ugolino	уголино
rostislavich	ростиславич
fortescue	фортескью
prado	прадо
furrer	фуррер
fessenden	фессенден
marsden	марсден
anu	ану
jacinto	хасинто
perón	перон
roldán	рольдан
samedov	самедов
anno	анно
gervais	жерве
hayek	хайек
renger	ренгер
ixtlilxochitl	иштлильшочитль
odom	одом
wiese	визе
rost	рост
hennig	хенниг
glauber	глаубер
erland	эрланд
panteleimon	пантелеимон
potapenko	потапенко
finley	финли
pavón	павон
mccormick	маккормик
arvo	арво
kazim	казим
roald	роальд
stroud	страуд
lilly	лилли
adrian	адриан
song	сун
rothschild	ротшильд
ono	оно
angus	ангус
mcgregor	макгрегор
han	хань
antipater	антипатр
neil	нил
henrik	хенрик
gert	герт
schlegel	шлегель
suvorov	суворов
lodge	лодж
bustamante	бустаманте
björn	бьёрн
feuerbach	фейербах
pelagius	пелагий
davydov	давыдов
dewar	дьюар
kornilov	корнилов
bykov	быков
komorowski	коморовский
biryukov	бирюков
yusupov	юсупов
viktorovich	викторович
sebastian	себастьян
sievers	зиверс
lehmann	леман
faruk	фарук
aidan	эйдан
joel	джоэл
moussa	мусса
mauri	маури
kuhn	кун
monteiro	монтейру
komnenos	комнин
pavlovna	павловна
ibrahim	ибрагим
sean	шон
berti	берти
doug	даг
bach	бах
anatoly	анатолий
stepan	степан
lydia	лидия
rossetti	россетти
valencia	валенсия
vahid	вахид
schröter	шрётер
gurevich	гуревич
vidal	видаль
darwin	дарвин
krebs	кребс
shulman	шульман
neto	нето
gandhi	ганди
varga	варга
gautier	готье
hui	хуэй
harley	харли
sanderson	сандерсон
rowan	роуэн
pia	пиа
demetrios	димитрий
amédée	амедей
elijah	элайджа
seo	со
pozzo	поццо
yates	йейтс
priscus	приск
rousset	руссе
dam	дам
głowacki	гловацкий
peña	пенья
bliss	блисс
doria	дориа
selim	селим
zeller	целлер
jerónimo	херонимо
frida	фрида
tyrrell	тиррелл
flora	флора
bear	медведь
elaine	элейн
salah	салах
sattar	саттар
anastasio	анастасио
nizar	низар
wilkes	уилкс
ephraim	эфраим
batista	батиста
demetrius	деметрий
marius	мариус
gaddafi	каддафи
carlisle	карлайл
lucian	лучиан
şahin	шахин
amaury	амори
pompeius	помпей
herz	герц
camille	камиль
doukas	дука
andrade	андраде
cross	кросс
san	сан
pratt	пратт
nichols	николс
carolyn	кэролин
abreu	абреу
forsyth	форсайт
godfrey	годфри
jón	йоун
christina	кристина
ibn	ибн
patricia	патриция
marcellus	марцелл
gonçalves	гонсалвес
peterson	петерсон
mahdi	махди
teresa	тереза
aubrey	обри
duane	дуэйн
langdon	лэнгдон
gian	джан
dufour	дюфур
jüri	юри
gould	гулд
hussein	хусейн
noah	ноа
burton	бёртон
pierce	пирс
heuss	хойс
harshavarman	харшаварман
ferdi	ферди
blanchflower	бланчфлауэр
hafner	хафнер
fischler	фишлер
grade	граде
rollo	роллон
garbarek	гарбарек
atli	атли
flatow	флатов
khama	кхама
eger	эгер
astra	астра
orit	орит
storace	сторас
queffélec	кеффелек
němeček	немечек
bainbridge	бейнбридж
aimard	эмар
hazlitt	хэзлитт
capra	капра
truxtun	тракстон
mengu	менгу
janssens	янсенс
darlene	дарлин
ryutaro	рютаро
whittaker	уиттакер
fourcade	фуркад
schaaf	шааф
spiro	спиро
tomokazu	томокадзу
bordone	бордоне
clem	клем
fukuyama	фукуяма
adrià	адрия
heymans	хейманс
garber	гарбер
bhutto	бхутто
belling	беллинг
čáp	чап
cassie	кэсси
buddha	буддха
söderberg	сёдерберг
peruzzi	перуцци
sixten	сикстен
tariku	тарику
jeter	джетер
furuya	фуруя
sargsyan	саркисян
bulgakov	булгаков
adu	аду
kurigalzu	куригальзу
hartog	хартог
gioseffo	джозеффо
wada	вада
abert	аберт
alaric	аларих
stankiewicz	станкевич
ker	кер
piazza	пьяцца
kleiber	клайбер
fulgencio	фульхенсио
estigarribia	эстигаррибия
satsuki	сацуки
gregson	грегсон
suzy	сюзи
bernhardt	бернхардт
stallone	сталлоне
bury	бьюри
jude	джуд
laza	лаза
westphal	вестфаль
catlin	кетлин
soro	соро
urrutia	уррутия
mauriac	мориак
worm	ворм
rop	роп
jarre	жарр
delvaux	дельво
braschi	браски
kazuko	кадзуко
kavan	каван
papanikolaou	папаниколау
campi	кампи
wahl	валь
bernini	бернини
lavrinovič	лавринович
finkelstein	финкельштейн
rautavaara	раутаваара
dolphin	дельфин
felici	феличи
croker	крокер
linton	линтон
milivoje	миливое
juhani	юхани
dominika	доминика
trifunović	трифунович
vašíček	вашичек
petržela	петржела
balian	балиан
gur	гур
ledesma	ледесма
matthijs	маттейс
salvio	сальвио
barthold	бартольд
bagrat	баграт
nicolas	николя
jirō	дзиро
niall	найалл
sano	сано
tawara	тавара
corinth	коринт
clavijo	клавихо
modigliani	модильяни
fichtel	фихтель
alcmenes	алкамен
kubrick	кубрик
mcginn	макгинн
janowitz	яновиц
savio	савио
marinov	маринов
dietzgen	дицген
šics	шицс
henie	хени
abendroth	абендрот
cloutier	клутье
davit	давит
minna	минна
ulisse	улиссе
ismet	исмет
burdisso	бурдиссо
vujčić	вуйчич
serafini	серафини
carreras	каррерас
consuelo	консуэло
kiichirō	киитиро
mengelberg	менгельберг
reverdy	реверди
guardia	гуардия
djamel	джамель
dorda	дорда
asō	асо
slavoljub	славолюб
aetius	аэтий
hysén	хюсен
jamil	джамиль
ražnatović	ражнатович
klug	клуг
veres	вереш
wendl	вендль
trikoupis	трикупис
friedel	фридель
salehi	салехи
haipeng	хайпэн
poirier	пуарье
klemen	клемен
iqbal	икбал
fa	фа
allik	аллик
finlay	финлей
jordana	джордана
mårtensson	мортенссон
persakis	персакис
nectanebo	нектанеб
shibata	сибата
trost	трост
boyadzhiev	бояджиев
thabo	табо
sigmar	зигмар
lepsius	лепсиус
ulam	улам
iolo	иоло
cova	кова
vandenberg	ванденберг
bassani	бассани
masanobu	масанобу
sugawara	сугавара
sewell	сьюэлл
dudić	дудич
villoresi	виллорези
probert	проберт
agassi	агасси
tino	тино
trezzini	трезини
matsuura	мацуура
botsaris	боцарис
riehl	риль
fisichella	физикелла
březina	бржезина
kexin	кэсинь
bemrose	бемроуз
tess	тесс
springfield	спрингфилд
oddi	одди
neuwirth	нойвирт
gerritsen	герритсен
cornwell	корнуэлл
kazuki	кадзуки
tardieu	тардьё
lechner	лехнер
haile	хайле
fürstenberg	фюрстенберг
nia	ниа
cormier	кормье
uçar	учар
räsänen	рясянен
hinkel	хинкель
donahue	донахью
craven	крэйвен
parente	паренте
erlanger	эрлангер
frankland	франкленд
nanda	нанда
weissenbruch	вейсенбрух
blasi	блази
ellsworth	эллсворт
parviainen	парвиайнен
cormon	кормон
nietzsche	ницше
theophrastus	теофраст
kare	кэр
rózsa	рожа
rotter	роттер
gershwin	гершвин
nim	ним
salva	сальва
jami	джами
jet	джет
jaar	джаар
fitzhugh	фицхью
hechler	хехлер
quintana	кинтана
wace	вас
ryōtarō	рётаро
omrani	омрани
moravčík	моравчик
garin	гарин
amick	амик
martinek	мартинек
hebert	хеберт
audra	одра
acerbi	ачерби
opel	опель
haseney	хазеней
craigie	крейги
dickens	диккенс
götze	гётце
shicheng	шичэн
carraro	карраро
bergson	бергсон
greaves	гривз
nobs	нобс
hermenegild	герменегильд
gupta	гупта
junge	юнге
jeremić	еремич
tarcisio	тарчизио
kazumi	кадзуми
hilson	хилсон
bulder	бюлдер
milano	милано
bosworth	босуорт
bødker	бёдкер
schelotto	скелотто
hiromichi	хиромити
minori	минори
chéron	шерон
stuckey	стаки
loredan	лоредано
schachner	шахнер
pantelić	пантелич
milman	милмэн
ćirić	чирич
seppo	сеппо
wernicke	вернике
samsu	самсу
blum	блюм
xenakis	ксенакис
couperin	куперен
toland	толанд
balint	балинт
antar	антар
natterer	наттерер
benvenuto	бенвенуто
mažuranić	мажуранич
ajay	аджай
yaodong	яодун
assar	ассар
mironov	миронов
kohut	кохут
sonck	сонк
aydın	айдын
thuram	тюрам
quintilian	квинтилиан
bertone	бертоне
brancati	бранкати
thoresen	торесен
oles	олесь
krstev	крстев
jezebel	иезавель
geyer	гейер
cavalera	кавалера
guerin	герин
guri	гури
mindy	минди
agathon	агатон
attenborough	аттенборо
bobadilla	бобадилья
boie	бойе
oku	оку
vanier	ванье
dallay	дале
farmiga	фармига
jibril	джибриль
fraenkel	френкель
goretti	горетти
mádl	мадл
samba	самба
blytt	блютт
aureliano	аурелиано
abbey	эбби
thai	тхай
allston	олстон
scarpa	скарпа
vasja	вася
deepak	дипак
jumbo	джамбо
honecker	хонеккер
paganin	паганин
planchon	планшон
parrocel	парросель
belgrano	бельграно
obermaier	обермайер
yıldırım	йылдырым
trapp	трапп
klengel	кленгель
jackett	джекетт
holter	холтер
muzio	муцио
adem	адем
fotis	фотис
leber	лебер
costanzo	костанцо
malczewski	мальчевский
dara	дара
kimiko	кимико
eads	идс
pelser	пелсер
papoulias	папульяс
aerts	артс
kebede	кебеде
varley	варли
sartorius	сарториус
tadanari	таданари
pruszkowski	прушковский
clouet	клуэ
puente	пуэнте
vanzetta	ванцетта
mesut	месут
ashmore	эшмор
tunney	танни
śniadecki	снядецкий
alpers	альперс
kochanowski	кохановский
westphalen	вестфален
spinrad	спинрад
ayne	айн
matsuno	мацуно
suso	сузо
gené	жене
arsenijević	арсениевич
alvim	алвим
fripp	фрипп
mcguigan	макгиган
wachtmeister	вахтмейстер
lesage	лесаж
lazzaro	ладзаро
prentice	прентис
wallenberg	валленберг
mansell	мэнселл
zsa	жа
cenci	ченчи
lazović	лазович
maalouf	маалуф
shōjirō	сёдзиро
shumi	шуми
scanlon	скэнлон
eichner	айхнер
sárosi	шароши
riggs	риггз
åström	острём
pharamond	фарамонд
genzken	генцкен
dougie	дуги
hackett	хэкетт
bamford	бэмфорд
stanislao	станислао
saturninus	сатурнин
evensen	эвенсен
nance	нэнс
russow	руссов
luckner	люкнер
hofer	хофер
chelimo	челимо
lindenstrauss	линденштраусс
detlef	детлеф
hércules	эркулес
hanfstaengl	ханфштенгль
olesya	олеся
egidio	эджидио
bynum	байнум
søndergaard	сённергор
ofra	офра
hasenclever	газенклевер
infante	инфанте
pines	пинес
burchell	бёрчелл
keitel	кейтель
pozzi	поцци
justyna	юстина
rico	рико
samuele	самуэле
zocchi	дзокки
agee	эйджи
severina	северина
cabrini	кабрини
schlumpf	шлумпф
yasuharu	ясухару
opaliński	опалинский
masatoshi	масатоси
mifune	мифунэ
boselli	боселли
michels	михельс
wieniawski	венявский
damodar	дамодар
borowski	боровский
curtin	кёртин
mathis	мэтис
fall	фалль
badham	бэдэм
nirari	нирари
fallon	фаллон
morandi	моранди
chandrika	чандрика
osment	осмент
ingold	ингольд
smits	смитс
radcliffe	рэдклифф
tatum	татум
hōjō	ходзё
brenton	брентон
czacki	чацкий
deming	деминг
jabotinsky	жаботинский
rutten	рюттен
joscelin	гозлен
czechowicz	чехович
utaka	утака
surtees	сёртис
babayaro	бабаяро
wiseman	уайзман
yankov	янков
stieber	штибер
parisi	паризи
yvon	ивон
zorzi	дзордзи
linus	линус
downes	даунз
barrault	барро
backe	бакке
colangelo	коланжело
timati	тимати
boardman	бордман
isaacs	айзекс
kiptanui	киптануи
ringer	рингер
malam	малам
playford	плейфорд
ponte	понте
bulatović	булатович
lotsij	лотси
coolio	кулио
furlan	фурлан
tomczyk	томчик
aparecido	апаресидо
carnera	карнера
hunyady	хуньяди
bremner	бремнер
alfio	альфио
capa	капа
sofer	софер
macrianus	макриан
sükhbaataryn	сухбаатарын
agesilaus	агесилай
mcgillis	макгиллис
tashi	таши
jagemann	ягеман
anneli	аннели
aesop	эзоп
piñera	пиньера
kofler	кофлер
divine	дивайн
slavík	славик
redknapp	реднапп
wittig	виттиг
buckner	бакнер
seiichi	сэйити
sackville	сэквилл
ast	аст
kreiner	крайнер
brillouin	бриллюэн
coles	коулс
nanri	нанри
ute	уте
szymkowiak	шимковяк
tryggvi	трюггви
baquero	бакеро
bihari	бихари
frommelt	фроммельт
feller	феллер
sumi	суми
speed	спид
ley	лей
bullinger	буллингер
lauder	лаудер
sanna	санна
edney	эдни
höller	хёллер
mccaffrey	маккефри
rollins	роллинз
lambruschini	ламбрускини
greenhoff	гринхофф
themistocles	фемистокл
lacoste	лакост
idi	иди
somerville	сомервилль
orth	орт
tanabe	танабэ
kitazawa	китадзава
fassi	фасси
egede	эгеде
hornsby	хорнсби
dörner	дёрнер
lička	личка
doctorow	доктороу
phoebe	фиби
amico	амико
morato	морато
jaki	яки
schlesser	шлессер
ryle	райл
bangura	бангура
raimondas	раймондас
zurbriggen	цурбригген
novello	новелло
blanqui	бланки
tahar	тахар
penev	пенев
simmel	зиммель
viorel	виорел
čavić	чавич
aniston	энистон
hattusili	хаттусили
obata	обата
arnould	арну
gosh	гош
matarazzo	матараццо
mali	мали
mařák	маржак
miliband	милибэнд
nazi	нази
toshihiko	тосихико
hamish	хэмиш
hasdeu	хашдеу
addams	аддамс
bonetto	бонетто
lamperti	ламперти
bonvin	бонвен
maki	маки
salas	салас
welsh	уэлш
melchiorre	мельхиоре
edwige	эдвиж
stansfield	стэнсфилд
seto	сэто
etherington	этерингтон
bertini	бертини
bonds	бондс
schlick	шлик
wooding	вудинг
mohan	мохан
kodama	кодама
saeko	саэко
jelle	йелле
appuleius	аппулей
pengfei	пэнфэй
light	лайт
choniates	хониат
vossen	воссен
pasqualino	паскуалино
abetti	абетти
shoichi	сёити
roeder	рёдер
deák	деак
bodor	бодор
fabretti	фабретти
yokoi	ёкои
ditana	дитана
vaknin	вакнин
iginio	иджинио
havránek	гавранек
maximiliano	максимилиано
cléry	клери
burrows	барроуз
michalka	мичалка
tallien	тальен
nejedlý	неедлы
hideko	хидэко
berisha	бериша
calderoni	кальдерони
hosseini	хоссейни
aznavour	азнавур
borja	борха
karapetyan	карапетян
kaitlyn	кейтлин
ayako	аяко
sveinsson	свейнссон
bosio	бозио
louisy	луизи
antiphon	антифонт
keiichi	кэйити
valdas	валдас
tagore	тагор
salviati	сальвиати
margot	маргот
besart	бесарт
giacomelli	джакомелли
srivastava	шривастава
donyarth	донарт
līga	лига
rolston	ролстон
towers	тауэрс
glennie	гленни
oduber	одубер
cockerill	кокрил
ugarte	угарте
kirkwood	кирквуд
badr	бадр
jepsen	джепсен
bertinotti	бертинотти
ribera	рибера
sócrates	сократес
martynas	мартинас
håkon	хокон
tseren	цэрэн
hristov	христов
mccool	маккул
baumgarten	баумгартен
bauhin	баугин
subašić	субашич
lentini	лентини
kubelík	кубелик
gattuso	гаттузо
alessandrini	алессандрини
gaskell	гаскелл
combs	комбс
zapp	цапп
berthelot	бертло
karjalainen	карьялайнен
grün	грюн
marcellin	марселен
lovelace	лавлейс
kubo	кубо
allred	оллред
kazuyo	кадзуё
argüello	аргуэльо
ermanno	эрманно
selçuk	сельчук
machin	машен
punch	панч
ruffy	руффи
merton	мертон
midorikawa	мидорикава
gräser	грезер
valero	валеро
knighton	найтон
simonas	симонас
lehtinen	лехтинен
terrell	террелл
orrin	оррин
gus	гас
jehoshaphat	иосафат
sengge	сенге
bergara	бергара
frings	фрингс
uziel	узиэль
commons	коммонс
yaniv	янив
wharton	уортон
puc	пуц
springer	шпрингер
wenjun	вэньцзюнь
mehsud	мехсуд
campana	кампана
tomlin	томлин
regulus	регул
girardi	жирарди
babos	бабош
lansana	лансана
shields	шилдс
moen	моэн
santi	санти
childress	чилдресс
makino	макино
kassar	кассар
guiraud	гиро
waldmüller	вальдмюллер
gilson	жильсон
jönsson	йонссон
hocking	хокинг
robitaille	робитайл
carrère	каррер
sedin	седин
konoe	коноэ
danilchenko	данильченко
busby	басби
haugen	хауген
fellgiebel	фельгибель
ildebrando	ильдебрандо
mägi	мяги
nazaire	назер
bégin	бежен
södergren	сёдергрен
hamdi	хамди
desiderius	дезидерий
macrae	макрей
oribe	орибе
koons	кунс
esaias	эсайас
escalante	эскаланте
silpa	силпа
pilař	пиларж
naranjo	наранхо
hayko	айко
bogarde	богард
doda	дода
illus	илл
otokar	отокар
ottorino	отторино
yasuyuki	ясуюки
wöhler	вёлер
hadik	хадик
negroponte	негропонте
stevica	стевица
vélez	велес
bethlen	бетлен
rouvier	рувье
peralta	перальта
lorenzetti	лоренцетти
shinichi	синъити
langford	лэнгфорд
blaže	блаже
noam	ноам
filipiak	филипяк
amor	амор
schramm	шрамм
maruyama	маруяма
nan	нань
ziętek	зентек
nerijus	нериюс
zachary	закари
heung	хын
willa	уилла
nicaise	никез
falke	фальке
blyth	блит
mimoun	мимун
biron	бирон
sansa	санса
stroppa	строппа
garland	гарленд
leontius	леонтий
raivis	райвис
olmi	ольми
orda	орда
nordhagen	нордхаген
guti	гути
amable	амабль
neschling	нешлинг
cesarini	чезарини
tió	тио
barda	барда
landowski	ландовски
biot	био
carpentier	карпантье
volpi	вольпи
cavallero	кавальеро
mantegna	мантенья
hodgkinson	ходжкинсон
lillard	лиллард
te	те
jerković	еркович
cafu	кафу
kek	кек
tubman	табмен
pauli	паули
havelock	хэвлок
carrà	карра
duclos	дюкло
lauro	лауро
greenaway	гринуэй
columbus	коламбус
winsor	уинзор
battle	бэттл
fini	фини
marrone	марроне
lenstra	ленстра
gasol	газоль
tiye	тия
imam	имам
standing	стэндинг
yuka	юка
amrita	амрита
virgo	вирго
constantinescu	константинеску
krstić	крстич
passy	пасси
bieber	бибер
yasunori	ясунори
panizza	паницца
ineta	инета
horta	орта
hagar	агарь
salaì	салаи
sarnoff	сарнофф
giampaolo	джампаоло
rosanna	розанна
kat	кэт
samar	самар
yishai	ишай
steinmetz	штейнмец
mies	мис
torrey	торри
nirmala	нирмала
mokoena	мокоена
grünewald	грюневальд
younghusband	янгхазбенд
barfield	барфилд
goehr	гёр
burks	бёркс
lawton	лоутон
rajavi	раджави
janotha	янота
karatasos	каратассос
gein	гейн
yuzuru	юдзуру
maka	мака
band	бэнд
krumm	крумм
mittermaier	миттермайер
greeley	грили
aall	оль
smolarek	смолярек
božović	божович
devereux	деверё
fathy	фатхи
kulcsár	кульчар
porush	поруш
schlink	шлинк
rareş	рареш
ponticus	понтийский
glantz	гланц
tower	тауэр
brongniart	броньяр
puerta	пуэрта
seppi	сеппи
marulanda	маруланда
guillemin	гиймен
worth	уорт
aladár	аладар
hiroya	хироя
comrie	комри
crusius	крузиус
ngawang	нгаванг
ouellet	уэлле
tashiro	тасиро
venter	вентер
mavor	мейвор
montiel	монтьель
lisowski	лисовски
magnussen	магнуссен
asada	асада
remington	ремингтон
brkić	бркич
philadelphus	филадельф
solana	солана
breck	брек
ibsen	ибсен
zabaleta	сабалета
ducasse	дюкасс
lanchester	ланчестер
cillian	киллиан
yibing	ибин
drăgoi	драгой
ferraro	ферраро
véronique	вероник
kälin	келин
china	чайна
papineau	папино
cartledge	картледж
grande	гранде
durbin	дурбин
hanoch	ханох
diakité	диаките
takayoshi	такаёси
leoš	леош
eben	эбен
yoshisada	ёсисада
lauenstein	лауэнштайн
mcdonagh	макдонах
przemysław	пшемыслав
dizzy	диззи
graedener	греденер
gámez	гамес
baumanis	бауманис
velimir	велимир
loyd	лойд
bradfield	брэдфилд
nesbitt	несбитт
lavelle	лавель
hartz	харц
scarone	скароне
singleton	синглтон
hattestad	хаттестад
shibutani	шибутани
goc	гоч
zilber	зильбер
golon	голон
grimau	гримау
okazaki	окадзаки
mach	мах
laine	лайне
tiko	тико
couturier	кутюрье
nakazawa	накадзава
otfried	отфрид
mamadi	мамади
johannesen	йоханнесен
trout	траут
ciardi	чиарди
kinsey	кинси
stebbins	стеббинс
catalani	каталани
kusugak	кусугак
sarkar	саркар
yelü	елюй
renshaw	реншоу
puhl	пуль
zezé	зезе
gül	гюль
modin	модин
cozens	козенс
wedge	уэдж
mitford	митфорд
torin	торин
delon	делон
marriner	марринер
autumn	отем
claret	кларет
malouda	малуда
kerli	кёрли
gárate	гарате
portinari	портинари
fujimoto	фудзимото
sumu	суму
fairfax	фэрфакс
balasko	баласко
stieglitz	штиглиц
masanori	масанори
ahola	ахола
kagawa	кагава
cagney	кэгни
silvestro	сильвестро
slick	слик
fano	фано
livni	ливни
zafferani	дзафферани
rowlandson	роулендсон
gaza	газа
alcântara	алкантара
dior	диор
rono	роно
torricelli	торричелли
balbo	бальбо
bergslien	бергслин
on	он
bordon	бордон
danko	данко
hedman	хедман
vikström	викстрём
roni	рони
casares	касарес
eastlake	истлейк
rothari	ротари
niemi	ниеми
angst	ангст
mizuta	мидзута
arai	араи
vilks	вилкс
eyskens	эйскенс
taddei	таддеи
ekström	экстрём
vávrová	ваврова
stich	штих
wendt	вендт
modersohn	модерзон
pastor	пастор
morata	мората
bum	бом
geldof	гелдоф
vernet	верне
evgraf	евграф
agnelo	агнелу
pinel	пинель
bonanno	бонанно
salam	салам
çelebi	челеби
kuniyoshi	куниёси
courier	курье
wynton	уинтон
rupp	рупп
simonsson	симонссон
pantoja	пантоха
nobuhiro	нобухиро
pinzón	пинсон
bilson	билсон
chagas	шагас
mississippi	миссисипи
chivu	киву
navas	навас
kabua	кабуа
socorro	сокорро
skarga	скарга
kichenok	киченок
sibusiso	сибусисо
ethan	итан
tinbergen	тинберген
planinc	планинц
peltier	пельтье
lleras	льерас
guerre	герр
mavrocordatos	маврокордат
whittle	уиттл
rajeev	раджив
christopoulos	христопулос
wojtkiewicz	войткевич
isherwood	ишервуд
lindblad	линдблад
vespasian	веспасиан
allman	оллман
staff	стафф
simo	симо
serdar	сердар
hanne	ханне
birkhoff	биркхоф
erishum	эришум
righi	риги
guggenberger	гуггенбергер
osmar	осмар
hein	хейн
nóbrega	нобрега
thelma	телма
zuma	зума
hasso	хассо
yukimura	юкимура
ichikawa	итикава
cortesi	кортези
mercader	меркадер
sollima	соллима
zorn	цорн
bendix	бендикс
rickard	рикард
barbaro	барбаро
friant	фриан
eubanks	юбенкс
olive	олив
minter	минтер
fortune	форчун
dlouhý	длоуги
bāṇabhaṭṭa	бана
skácel	скацел
kipyego	кипьего
prout	праут
arns	арнс
assemani	ассемани
bosley	босли
tōgō	того
siyabonga	сиябонга
brain	брейн
nesvadba	несвадба
bridgman	бриджмен
riesz	риес
celsius	цельсий
conquest	конквест
vergara	вергара
torcuato	торкуато
vivaldi	вивальди
kubica	кубица
cipriano	сиприано
harthi	харти
ola	ола
harro	харро
sebag	себаг
callie	кэлли
pugh	пью
urbano	урбано
arruabarrena	арруабаррена
nakagawa	накагава
karadžić	караджич
straka	страка
clérambault	клерамбо
fire	файер
dundee	данди
shikibu	сикибу
jada	джада
simmler	зимлер
aurore	орор
abderrahmane	абдеррахман
nizami	низами
véliz	велис
millet	милле
moldovan	молдован
pentland	пентланд
lichtenberg	лихтенберг
tawfik	тауфик
murasaki	мурасаки
sontag	зонтаг
riba	риба
yining	инин
arcand	аркан
gullickson	галликсон
hansi	ханси
haya	хайя
eliáš	элиаш
harkness	харкнесс
massee	масси
dijkstra	дейкстра
dasgupta	дасгупта
onno	онно
brožková	брожкова
carney	карни
babatunde	бабатунде
nyborg	нюборг
lai	лай
changxing	чансин
němcová	немцова
simoncelli	симончелли
favart	фавар
kuroń	куронь
blier	блие
ramesh	рамеш
dagmar	дагмар
spindleshanks	тонконогий
rantzau	ранцау
azizi	азизи
reccared	реккаред
harrer	харрер
molinaro	молинаро
haqqani	хаккани
exley	эксли
fichte	фихте
assunção	ассунсао
vänskä	вянскя
sutkus	суткус
cárdenas	карденас
matsys	массейс
goya	гойя
kirui	кируи
rigg	ригг
bedell	беделл
bedingfield	бедингфилд
riario	риарио
mercado	меркадо
loureiro	лоурейру
libertad	либертад
ardashir	арташир
sakura	сакура
kvapil	квапил
ramzi	рамзи
liuva	лиува
saskia	саския
messerschmidt	мессершмидт
phuong	фыонг
shuvalov	шувалов
forlán	форлан
parrott	пэрротт
petrosyan	петросян
imamura	имамура
loomis	лумис
dragoslav	драгослав
midori	мидори
mukesh	мукеш
ambani	амбани
deron	дерон
dubravčić	дубравчич
vasiliauskas	василяускас
lohse	лозе
alwin	альвин
sádlo	садло
ushijima	усидзима
radford	рэдфорд
petrucci	петруччи
starace	стараче
sheshonk	шешонк
negro	негро
hellström	хельстрём
veikko	вейкко
wortmann	вортманн
darrow	дэрроу
unger	унгер
kafka	кафка
tardelli	тарделли
cruyff	кройф
novotná	новотна
waagen	вааген
bethune	бетьюн
mathurin	матюрен
kanai	канаи
suzman	сазман
haigneré	эньере
ehret	эрет
elfego	эльфего
cheever	чивер
torrado	торрадо
celmiņš	целминьш
makris	макрис
süleymanoğlu	сулейманоглу
tuti	тути
juskowiak	юсковяк
rómulo	ромуло
şamyradow	шамурадов
mijatović	миятович
dutra	дутра
rausch	рауш
grzimek	гржимек
maunoury	монури
klopp	клопп
mucha	муха
trueba	труэба
glaser	глазер
perdue	пердью
doron	дорон
kouba	коуба
arbo	арбо
bolger	болджер
yona	йона
codina	кодина
radama	радама
waltraud	вальтрауд
baran	баран
roos	роос
doig	дойг
sarit	сарит
okello	окелло
einstein	эйнштейн
obadiah	авдий
leroux	леру
fenton	фентон
ngo	нго
ljudevit	людевит
quinteros	кинтерос
froment	фроман
česnauskis	чеснаускис
paulista	паулиста
džemal	джемал
margarete	маргарете
yaya	яя
küchler	кюхлер
zaha	заха
enomoto	эномото
sapir	сапир
gul	гуль
highmore	хаймор
shigenobu	сигэнобу
daukša	даукша
taeko	таэко
delorme	делорм
kawajiri	кавадзири
kübler	кюблер
assis	ассис
grünenfelder	грюненфельдер
kinuyo	кинуё
necho	нехо
hass	хасс
morello	морелло
korzeniowski	корженёвский
zeballos	себальос
prokhorov	прохоров
pappas	паппас
compagnoni	компаньони
kishi	киси
coffey	коффи
ingūna	ингуна
semper	земпер
trivunović	тривунович
prosdocimus	просдоций
haüy	гаюи
savard	савар
whalen	уэйлен
ishmael	измаил
konno	конно
barroso	баррозу
bush	буш
einaudi	эйнауди
jünger	юнгер
băsescu	бэсеску
scheel	шеель
löwe	лёве
etty	этти
bleek	блик
cy	сай
poletti	полетти
fagan	фэган
blagoje	благое
kabila	кабила
almásy	алмаши
matvei	матвей
burhanuddin	бурхануддин
cambon	камбон
rochus	рохус
roelofs	рулофс
cunego	кунего
moroder	мородер
vogler	фоглер
friday	фрайдей
kühner	кюнер
ekberg	экберг
kitagawa	китагава
kynaston	кинастон
sokk	сокк
alter	альтер
hautala	хаутала
tomoki	томоки
cuyp	кёйп
tomoyuki	томоюки
frossard	фроссар
klöden	клёден
postma	постма
bratislav	братислав
tsendiin	цэндийн
janyk	яник
grandes	грандес
rabiu	рабиу
kober	кобер
grazia	грация
sunderland	сандерленд
sergeyev	сергеев
achillini	акиллини
bonfante	бонфанте
nagai	нагаи
fugger	фуггер
jialiang	цзялян
ribas	рибас
stas	стас
reiko	рэйко
dittrich	диттрих
dickey	дики
amira	амира
alanis	аланис
granit	гранит
pileggi	пиледжи
duchesnay	дюшене
gracián	грасиан
haavisto	хаависто
weintraub	вейнтрауб
vesta	веста
guilford	гилфорд
rivas	ривас
higuchi	хигути
michihiro	митихиро
prest	прест
chambers	чемберс
voynich	войнич
thornhill	торнхилл
heym	гейм
kristjan	кристьян
bava	бава
aretino	аретино
pinilla	пинилья
sophonisba	софонисба
spillane	спиллейн
bankhead	бэнкхед
dax	дакс
filippi	филиппи
pavić	павич
tomei	томей
massera	массера
münter	мюнтер
nikitas	никитас
harmon	хэрмон
gertler	гертлер
corbet	корбет
tzipi	ципи
latvala	латвала
veličković	величкович
haslem	хаслем
sayuri	саюри
evangelos	евангелос
lindqvist	линдквист
valla	валла
clavel	клавель
slater	слэйтер
aulin	аулин
rock	рок
street	стрит
maravilha	маравилья
burak	бурак
moresby	морсби
chesney	чесни
mundy	манди
kaneto	канэто
nikolopoulos	николопулос
xinxin	синьсинь
friis	фриис
wiklund	виклунд
fatmir	фатмир
ingmann	ингманн
salama	салама
hor	хор
karami	караме
trollope	троллоп
duvalier	дювалье
bartłomiej	бартломей
lilja	лилья
vahirua	ваируа
rendell	ренделл
alois	алоис
buster	бастер
deller	деллер
grandin	грандин
jaana	яана
thakur	тхакур
cavallini	каваллини
kiprono	кипроно
tippett	типпетт
jodl	йодль
savo	саво
justice	джастис
soćko	соцко
tarabini	тарабини
verger	верже
geraldine	джеральдин
kamehameha	камеамеа
mccrory	маккрори
dică	дикэ
fesch	феш
vecchi	векки
taniguchi	танигути
hedges	хеджес
sinéad	шинейд
olds	олдс
anthelme	антельм
nunn	нанн
brossard	броссар
dunning	даннинг
gyan	гьян
bubenko	бубенко
manus	манус
country	кантри
dodik	додик
aunli	эунли
volusianus	волузиан
jardel	жардел
merry	мерри
lagerkvist	лагерквист
taek	тхэк
kumm	кумм
gabrieli	габриели
tuomioja	туомиоя
sidibé	сидибе
philometor	филометор
sakari	сакари
antonioli	антониоли
avenarius	авенариус
carlström	карлстрём
ramis	рамис
pinter	пинтер
aitor	айтор
atwood	этвуд
klingenberg	клингенберг
benko	бенко
sunil	сунил
rina	рина
rupnik	рупник
elm	эльм
swings	свингс
schreiber	шрайбер
kamdem	камдем
binnie	бинни
teitelbaum	тейтельбаум
mariela	мариэла
cockburn	кокберн
ruutu	рууту
foulkes	фоулкс
branch	брэнч
paredes	паредес
dembélé	дембеле
kegel	кегель
birks	биркс
shapley	шепли
gaahl	гаал
newberry	ньюберри
nye	най
kerstin	керстин
farrow	фэрроу
stockwell	стоквелл
lydon	лайдон
akashi	акаси
tsvetana	цветана
landers	ландерс
ghassan	гассан
mahesh	махеш
misty	мисти
cavallari	каваллари
leonora	леонора
rigoni	ригони
rama	рама
linley	линли
livio	ливио
aloni	алони
halas	халас
grosjean	грожан
ranković	ранкович
gertsch	герч
restrepo	рестрепо
babaji	бабаджи
kirsi	кирси
bernardin	бернарден
gélinas	желина
langer	лангер
amage	амага
prey	прей
alterman	альтерман
mascheroni	маскерони
daron	дарон
elizondo	элисондо
kröger	крёгер
mainardi	майнарди
mirela	мирела
caccini	каччини
florschütz	флоршюц
hanbury	хэнбери
zvonko	звонко
uta	ута
barnum	барнум
tanith	танит
motwani	мотвани
scarlet	скарлет
coventry	ковентри
tadeja	тадея
kirsty	кирсти
nebojša	небойша
merlo	мерло
yvette	иветт
kashiwagi	касиваги
sadoul	садуль
sune	суне
jochem	йохем
dukurs	дукурс
llorente	льоренте
tejada	техада
hantili	хантили
caecilia	цецилия
szabolcs	сабольч
mayuko	маюко
peçanha	песанья
rocker	рокер
mairesse	мэресс
yasutaka	ясутака
nini	нини
koroma	корома
barış	барыш
montell	монтелл
essam	эссам
leander	леандер
lumley	ламли
lothair	лотарь
zidanta	циданта
iveković	ивекович
mutis	мутис
unsworth	ансуорт
batten	баттен
blažek	блажек
cacho	качо
hisashi	хисаси
ormond	ормонд
devrient	девриент
lipps	липпс
coletti	колетти
dane	дэйн
amundsen	амундсен
jaynes	джейнс
shiho	сихо
akarsu	акарсу
ornella	орнелла
ostrogski	острожский
wasilewski	василевский
páez	паэс
hampel	хампель
farahnaz	фарахназ
boccaccino	бокаччино
kerem	керем
olbrich	ольбрих
horák	горак
kono	коно
wisdom	уиздом
rümker	рюмкер
errico	эррико
rucellai	ручеллаи
gandolfi	гандольфи
mednis	меднис
mimmi	мимми
lonnie	лонни
bonetti	бонетти
nabu	набу
pahor	пахор
feliński	фелинский
feininger	фейнингер
lenk	ленк
spinosi	спинози
hikari	хикари
pinelli	пинелли
ōe	оэ
tutu	туту
audouin	одуэн
damien	дамьен
jammeh	джамме
demarcus	демаркус
bramah	брама
sevilla	севилья
stojanovski	стояновски
sifakis	сифакис
corley	корли
kitano	китано
tiff	тифф
timmy	тимми
moor	моор
thorbjørn	турбьёрн
ramadan	рамадан
hirt	хирт
kaberle	каберле
messager	мессаже
moorehead	мурхед
ascherson	ашерсон
alana	алана
kawasumi	кавасуми
sirén	сирен
gan	гань
aono	аоно
cattaneo	каттанео
jingyu	цзинъюй
oldfield	олдфилд
eldredge	элдридж
hurt	хёрт
carnegie	карнеги
thunberg	тунберг
steingrímur	стейнгримур
frenzel	френцель
beyrle	байерли
sanae	санаэ
dempster	демпстер
sakuramachi	сакурамати
lambrakis	ламбракис
safi	сафи
puig	пуиг
langen	ланген
pirmin	пирмин
crystal	кристал
uğur	угур
grubb	грабб
eberhardt	эберхардт
graciela	грасьела
schuldt	шульдт
mcglinchey	макглинчи
gonda	гонда
susskind	сасскинд
andrić	андрич
livermore	ливермор
verdon	вердон
hata	хата
stump	стамп
lépine	лепин
plater	плятер
halperin	гальперин
wilford	уилфорд
carioca	кариока
lindvall	линдвалл
teodora	теодора
rădulescu	рэдулеску
asger	асгер
heli	хели
rossum	россум
dileita	дилейта
delibašić	делибашич
emine	эмине
pinnock	пиннок
aco	ацо
mads	мадс
masaryk	масарик
beda	беда
trisha	триша
daina	дайна
egerton	эгертон
amigo	амиго
ásgrímsson	аусгримссон
lauris	лаурис
tõnisson	тыниссон
barghouti	баргути
haidar	хайдар
haupt	хаупт
strigel	штригель
pollux	поллукс
papakonstantinou	папаконстантину
flinders	флиндерс
bothe	боте
kiszka	кишка
apollo	аполло
forstner	форстнер
borounov	борунов
ionesco	ионеско
kitarō	китаро
zambrano	самбрано
nadi	нади
keleti	келети
boit	бойт
yosano	ёсано
ikezawa	икэдзава
presl	пресл
diesel	дизель
bernt	бернт
arianna	арианна
flatau	флатау
zöller	цёллер
kyriakos	кириакос
kranjčar	краньчар
stoica	стойка
asami	асами
thea	теа
dressel	дрессель
bel	бел
dukakis	дукакис
bandinelli	бандинелли
marijan	мариян
nedvěd	недвед
pop	поп
aoi	аой
slezak	слезак
smoot	смут
burrell	баррелл
radwańska	радваньская
efstathios	эфстатиос
armfield	армфилд
matsushita	мацусита
inzaghi	индзаги
laudrup	лаудруп
bonnard	боннар
florentino	флорентино
riedle	ридле
boubacar	бубакар
dorsey	дорси
sanogo	саного
arik	арик
paraskevopoulos	параскевопулос
winterbottom	уинтерботтом
seinfeld	сайнфелд
perrineau	перрино
togliatti	тольятти
vian	виан
ofarim	офарим
bakhtiar	бахтияр
ehrenberg	эренберг
anette	анетт
ruysch	рюйш
porta	порта
pečnik	печник
bowlby	боулби
adelman	адельман
zuccari	цуккаро
goodyear	гудьир
vlček	влчек
rimmer	риммер
kanako	канако
konstantinas	константинас
mikalojus	микалоюс
galder	гальдер
forlì	форли
gwendolyn	гвендолин
mekonnen	меконнен
krasimir	красимир
smokey	смоки
martinelli	мартинелли
soutsos	суцос
soros	сорос
rajko	райко
emiliani	эмилиани
cordero	кордеро
mchugh	макхью
tiso	тисо
thaddeus	таддеус
hannigan	ханниган
whittier	уиттер
mestel	местел
havoc	хэвок
tirtha	тиртха
gotch	готч
santoro	санторо
kosik	косик
stocklasa	штоклаза
hardiman	хардиман
fumihiko	фумихико
mistral	мистраль
collinson	коллинсон
sereni	серени
shiva	шива
caldera	кальдера
meera	мирабай
đukanović	джуканович
mariska	маришка
zöllner	цёлльнер
mey	мей
milner	милнер
shimazu	симадзу
heleno	элено
ecclestone	экклстоун
murayama	мураяма
villani	виллани
halina	халина
amott	эмотт
markowitz	марковиц
hammill	хэммилл
nannini	наннини
burmeister	бурмейстер
borda	борда
fares	фарес
schiller	шиллер
nikolayev	николаев
edmonds	эдмондс
noir	нуар
diop	диоп
kellenberger	келленбергер
eudoxia	евдоксия
krasniqi	красничи
madelung	маделунг
berkovich	беркович
lalo	лало
paes	паес
papin	папен
westerholt	вестерхольт
akif	акиф
aelia	элия
fraga	фрага
mccall	макколл
ozan	озан
gotthold	готхольд
berl	берл
beerbohm	бирбом
indiana	индиана
lanz	ланц
bucci	буччи
erró	эрро
fiori	фьори
brittney	бриттни
sarabski	сарабский
lemaire	лемер
norling	норлинг
clauberg	клауберг
erden	эрден
zhongshu	чжуншу
muti	мути
sacristán	сакристан
takahara	такахара
costin	костин
blackman	блэкман
bartsch	барч
hofland	хофланд
catesby	кейтсби
sæther	сетер
laird	лэрд
ozaki	одзаки
flack	флэк
ameobi	амеоби
rebekah	ребека
jokić	йокич
arnoldson	арнольдсон
bourdon	бурдон
zeta	зета
karamanlis	караманлис
puri	пури
eleni	элени
radim	радим
laakso	лааксо
willing	уиллинг
haug	хауг
vigée	виже
rimini	римини
arreola	арреола
laure	лор
viana	виана
bonita	бонита
karadeniz	карадениз
nagaoka	нагаока
hackl	хакль
jamin	жамен
lanckoroński	лянцкоронский
linger	лингер
boka	бока
martić	мартич
kalējs	калейс
twersky	тверский
rostock	росток
caitlin	кэйтлин
vlasak	власак
iizuka	иидзука
hannelore	ханнелоре
kardec	кардек
marnie	марни
conceição	консейсао
milito	милито
ribbeck	риббек
shakir	шакир
pot	пот
campanella	кампанелла
burger	бургер
dini	дини
alyssa	алисса
bártová	бартова
pang	пан
ideler	иделер
cimarosa	чимароза
mamo	мамо
neve	нив
barbro	барбро
neuhaus	нойхаус
terauchi	тэраути
vettori	веттори
guttenberg	гуттенберг
reichel	рейшель
siodmak	сиодмак
bolbochán	болбочан
tia	тиа
amarilla	амарилья
kuusisto	куусисто
gaucelm	госельм
savka	савка
cockcroft	кокрофт
mieszkowic	мешкович
rabin	рабин
klaproth	клапрот
fortunato	фортунато
adelung	аделунг
hemsworth	хемсворт
preminger	премингер
messmer	мессмер
mchale	макхейл
klich	клих
lobe	лобе
marciano	марчиано
toumani	тумани
finger	фингер
holiday	холидэй
stanimir	станимир
daisy	дэйзи
politzer	политцер
robison	робисон
apfel	апфель
carnot	карно
garrido	гарридо
hester	хестер
todi	тоди
mindaugas	миндаугас
linderoth	линдерот
chevillard	шевийяр
zeno	зено
rostand	ростан
sanjay	санджай
triana	триана
djorkaeff	джоркаефф
mulder	мюлдер
bettino	беттино
cassander	кассандр
verkerk	веркерк
gebre	гебре
keren	керен
tukiainen	тукиайнен
comfort	комфорт
marella	марелла
riordan	риордан
kuczynski	кучинский
niedermayer	нидермайер
balbinus	бальбин
aufrecht	ауфрехт
beklemishev	беклемишев
moira	мойра
girardot	жирардо
qiu	цю
buache	бюаш
marsal	марсаль
faison	фэйсон
annius	анний
basu	басу
flaminio	фламинио
perls	перлз
eugênio	эуженио
teshigahara	тэсигахара
priuli	приули
thees	тес
guhel	гюэль
hanks	хэнкс
pennell	пеннелл
tomlinson	томлинсон
roko	роко
velička	величка
darnell	дарнелл
kossuth	кошут
kiwanuka	киванука
advani	адвани
pasquier	паскье
hossa	хосса
memmi	мемми
tisza	тиса
salo	сало
blow	блоу
mesbah	месбах
tacchinardi	таккинарди
mcdougall	макдугалл
popp	попп
sears	сирс
goma	гома
isidro	исидро
tarquini	тарквини
salerno	салерно
gariboldi	гарибольди
tamburini	тамбурини
codrington	кодрингтон
amari	амари
bleekemolen	блекемолен
canini	канини
niinistö	нийнистё
canetti	канетти
zang	цзан
hersh	херш
fuyumi	фуюми
bergner	бергнер
masumi	масуми
schleicher	шлейхер
caprara	капрара
aeneas	эней
shiraishi	сираиси
selden	селден
coutinho	коутиньо
stian	стиан
aubert	обер
legnani	леньяни
lamas	ламас
miralem	миралем
mastroianni	мастроянни
prem	прем
deva	дэва
balibar	балибар
antonella	антонелла
wiedemann	видеман
dujmović	дуймович
oncken	онкен
takaaki	такааки
patinkin	патинкин
hezekiah	езекия
warrick	уоррик
madhav	мадхав
goebbels	геббельс
poivre	пуавр
theroux	теру
metin	метин
souchon	сушон
haber	хабер
capshaw	кэпшоу
penck	пенк
ihsahn	исан
bowden	боуден
katrina	катрина
gowland	гоуленд
fife	файф
kelemen	келемен
lecavalier	лекавалье
bunyan	баньян
maret	марет
lem	лем
kazan	казан
urbani	урбани
agrippina	агриппина
balme	бальм
rydell	райделл
eun	ын
markham	маркэм
żewłakow	жевлаков
panula	панула
locke	локк
mcgrory	макгрори
slade	слейд
salinger	сэлинджер
giusti	джусти
mollison	моллисон
lita	лита
cochet	коше
brockmann	брокман
karoli	кароли
scherrer	шеррер
picchi	пикки
couto	коуту
curcio	курчо
vanni	ванни
brambilla	брамбилла
cevdet	джевдет
rung	рунг
holmström	хольмстрём
fabi	фаби
nelligan	неллиган
ledoux	леду
broca	брока
mulroney	малруни
coria	кориа
michałowski	михаловский
cañas	каньяс
has	хас
gadi	гади
tiziano	тициано
hideyoshi	хидэёси
yonge	йондж
pissarro	писсарро
nalepa	налепа
cherie	шери
milla	милла
žanis	жанис
halle	халле
pettersen	петтерсен
valerie	валери
erdem	эрдем
boroujerdi	боруджерди
messenius	мессениус
pickard	пикард
machel	машел
baader	баадер
schmundt	шмундт
buchner	бухнер
grimani	гримани
shaul	шауль
childers	чайлдерс
narain	нараин
mölgg	мёльгг
vestris	вестрис
guilbert	гильбер
jedediah	джедедайя
stresemann	штреземан
hawley	хоули
aenne	энне
graça	граса
begin	бегин
aloisi	алоизи
đuričić	джуричич
wemyss	уимс
budge	бадж
grisi	гризи
heppner	хеппнер
torgny	торгни
ripa	рипа
schaff	шафф
jobs	джобс
carbonero	карбонеро
xia	ся
kadamba	кадамба
fukuhara	фукухара
abbiati	аббьяти
rolla	ролла
sodré	содре
wetter	веттер
manley	мэнли
michelsen	микельсен
lolli	лолли
matsuo	мацуо
clouzot	клузо
solari	солари
hayter	хейтер
horik	хорик
orsi	орси
uldis	улдис
nastassja	настасья
minako	минако
naruse	нарусэ
jere	йере
navvab	навваб
quaid	куэйд
warden	уорден
beckert	беккерт
ezekiel	иезекииль
katongo	катонго
chick	чик
buffon	буффон
gianluigi	джанлуиджи
basile	базиле
sommers	соммерс
schur	шур
demetrio	деметрио
kell	келл
blackmore	блэкмор
sáenz	саэнс
segura	сегура
pickett	пикетт
morland	морланд
stanić	станич
otte	отте
caesonia	цезония
canby	кэнби
beata	беата
enar	энар
biddle	биддл
galván	гальван
ibárruri	ибаррури
rother	ротер
montbrun	монбрен
newbury	ньюбери
moscovici	московичи
ittenbach	иттенбах
domitian	домициан
peace	пис
baumgartner	баумгартнер
fierro	фьерро
miljan	милян
meili	мейли
nieminen	ниеминен
sublette	саблетт
eckersley	экерсли
gallois	галлуа
khoury	хури
gaëtan	гаэтан
teyber	тайбер
insúa	инсуа
marissa	марисса
hilmar	хилмар
tarkki	таркки
bernal	берналь
enescu	энеску
schwarzschild	шварцшильд
clegg	клегг
freundlich	фрейндлих
sigourney	сигурни
nagashima	нагасима
valente	валенте
vila	вила
venclova	венцлова
takeshita	такэсита
maar	маар
chulanont	чуланонт
czartoryski	чарторыйский
stu	стю
joyner	джойнер
clary	клари
kōyō	коё
aripert	ариперт
vujadinović	вуядинович
chilperic	хильперик
morawitz	моравиц
landé	ланде
nalbandian	налбандян
sauvé	сове
osorkon	осоркон
sugita	сугита
castaldi	кастальди
mcilroy	макилрой
reese	риз
radka	радка
bloom	блум
confalonieri	конфалоньери
kusch	куш
posadas	посадас
bassi	басси
malkhaz	малхаз
droz	дро
siri	сири
kumai	кумаи
deacon	дикон
delano	делано
huggins	хаггинс
dita	дита
friðrik	фридрик
friðriksson	фридрикссон
ikuta	икута
radmanović	радманович
ebenezer	эбенезер
ingemar	ингемар
falconer	фальконер
klinghoffer	клингхоффер
decugis	декюжи
strange	стрейндж
matsuda	мацуда
adjei	аджей
melchor	мельчор
dashi	даши
wieser	визер
manin	манин
bhagat	бхагат
korshunov	коршунов
filipa	филипа
severo	северо
tribuno	трибуно
vukić	вукич
ohana	оана
wolski	вольский
slaviša	славиша
senad	сенад
dooling	дулинг
goodfellow	гудфеллоу
fagundes	фагундес
kilby	килби
kolehmainen	колехмайнен
thera	тхера
pina	пина
jonquet	жонке
belushi	белуши
sosnowski	сосновский
landis	лэндис
bateman	бейтман
kossel	коссель
simenon	сименон
gay	гей
solo	соло
tetsuya	тэцуя
fujimori	фухимори
lamoureux	ламурё
pasi	паси
thein	тейн
germar	гермар
thich	тхить
ljupčo	люпчо
coronado	коронадо
temile	темиле
hofstadter	хофштадтер
cahill	кэхилл
ranko	ранко
belén	белен
vivi	виви
gilroy	гилрой
bellingham	беллингем
menon	менон
arnoldo	арнольдо
jankowski	янковский
peta	пета
kawabe	кавабэ
lansky	лански
toso	тозо
hartig	гартиг
audran	одран
estes	эстес
wisliceny	вислицени
hanlon	хэнлон
hillman	хиллман
rizzo	риззо
barba	барба
auger	оже
tarjei	тарьей
pin	пин
lewenhaupt	левенгаупт
hollins	холлинс
garrick	гаррик
bousquet	буске
botella	ботелья
afolabi	афолаби
budõlin	будылин
celsus	цельс
yoni	йони
cobain	кобейн
avramović	аврамович
masing	мазинг
obafemi	обафеми
vrančić	вранчич
pollen	поллен
higginson	хиггинсон
błażej	блажей
tandy	тэнди
chamberlin	чемберлин
timmer	тиммер
ryong	рён
kjerulf	кьерульф
blundell	бланделл
julin	юлин
rauch	раух
hayward	хэйуорд
tsujii	цудзии
eichler	эйхлер
naidoo	найду
grigoris	григорис
allori	аллори
perino	перино
fahrudin	фахрудин
kukk	кукк
halfdan	хальфдан
cardenal	карденаль
dobriansky	добрянски
suter	сутер
taguchi	тагути
włodarczyk	влодарчик
kolettis	колеттис
drašković	драшкович
philemon	филимон
elden	элден
helmer	хельмер
catalano	каталано
lallukka	лаллукка
borghi	борги
pidgeon	пиджон
eleazar	элеасар
densmore	денсмор
słonimski	слонимский
savón	савон
seba	себа
cuéllar	куэльяр
scheider	шайдер
dragiša	драгиша
helveg	хельвег
gvozdenović	гвозденович
arango	аранго
mohn	мон
serginho	сержиньо
öhlund	элунд
srečko	сречко
kallur	каллур
racoviță	раковицэ
lokvenc	локвенц
gunilla	гунилла
belmonte	бельмонте
aimee	эйми
toshiyuki	тосиюки
stehle	штеле
radonjić	радонич
medardo	медардо
nishimura	нисимура
hensley	хенсли
justine	жюстин
merga	мерга
afandi	афанди
lyle	лайл
birgitta	биргитта
norm	норм
kaczyński	качиньский
braxton	брэкстон
taavi	таави
callot	калло
etheridge	этеридж
longley	лонгли
kladas	кладас
saraiva	сарайва
serrão	серран
jumblatt	джумблат
matos	матос
sly	слай
grabowski	грабовский
nägeli	негели
türk	тюрк
medel	медель
ohba	оба
kerrigan	керриган
hersi	херси
zahari	захарий
revson	ревсон
shigeo	сигэо
bredow	бредов
shinn	шинн
mdivani	мдивани
bobo	бобо
leeson	лисон
bédard	бедар
falla	фалья
hayley	хэйли
biz	биз
shamrock	шемрок
garay	гарай
takahito	такахито
louvet	луве
ta	та
azhari	азхари
maturana	матурана
modesto	модесто
quang	куанг
lari	лари
moyes	мойес
moreelse	морельсе
gosia	гося
kremers	кремерс
poisson	пуассон
rubik	рубик
mckean	маккин
kästner	кестнер
westergaard	вестергор
shohreh	шохре
lehel	леле
nnamdi	ннамди
toshikazu	тосикадзу
burka	бурка
lark	ларк
doina	дойна
kravitz	кравиц
mizrahi	мизрахи
minogue	миноуг
schranz	шранц
escoffier	эскофье
rohrer	рорер
laizāns	лайзан
brack	брак
vassilis	вассилис
cleomenes	клеомен
viktoras	викторас
talfah	тульфах
jāzeps	язепс
jurado	хурадо
satu	сату
antonello	антонелло
paget	пэджет
boghossian	богоссян
hongzhi	хунчжи
hamill	хэмилл
brandy	брэнди
ismay	исмей
sophus	софус
mazari	мазари
wheaton	уитон
sotirios	сотириос
cates	кейтс
urdinarán	урдинаран
sacconi	саккони
rand	рэнд
hoeneß	хёнесс
tolis	толис
sakis	сакис
caracciolo	караччиоли
giannini	джаннини
drover	дровер
trivulzio	тривульцио
nurkse	нурксе
prima	прима
takayama	такаяма
rainulf	райнульф
momsen	момсен
costanza	костанца
noda	нода
holder	холдер
walras	вальрас
lucescu	луческу
flor	флор
ledru	ледрю
arfa	арфа
divina	дивина
guillaumin	гийомен
yalçınkaya	ялчинкая
abdirahman	абдирахман
avellaneda	авельянеда
sierra	сьерра
ricard	рикар
brocchi	брокки
mukhtarov	мухтаров
mukhtar	мухтар
cadorna	кадорна
romer	ромер
schmeichel	шмейхель
sepúlveda	сепульведа
barbour	барбур
soledad	соледад
iliev	илиев
soloveitchik	соловейчик
solanas	соланас
reiche	райхе
pringle	прингл
hoshi	хоси
dancy	дэнси
brnović	брнович
cassin	кассен
zawadzki	завадский
nathanael	натанаель
lassen	лассен
mitropoulos	митропулос
sobociński	собочинский
bonin	бонин
tomić	томич
bene	бене
krivine	кривин
arguedas	аргедас
dorota	дорота
sacchi	сакки
shūichi	сюити
yared	яред
sarli	сарли
korsak	корсак
kostner	костнер
pyle	пайл
drukpa	друкпа
colletti	коллетти
bresson	брессон
arkadiusz	аркадиуш
kosuke	косукэ
talich	талих
kostrzewski	костжевский
ampère	ампер
hietala	хиетала
necdet	недждет
gerrard	джеррард
götz	гётц
silverman	сильверман
karijotas	кориат
abicht	абихт
greif	грейф
abbo	аббон
jena	джена
foggia	фоджа
huda	худа
abdullayev	абдуллаев
baldivieso	бальдивьесо
małgorzata	малгожата
mila	мила
stavenhagen	ставенхаген
epps	эппс
jelly	джелли
axelsson	аксельссон
wittenberg	виттенберг
miri	мири
svěrák	сверак
rehman	рехман
näslund	нэслунд
holst	холст
pollini	поллини
trovoada	тровоада
aşık	ашик
forgács	форгач
tabaré	табаре
ney	ней
chartier	шартье
güttler	гюттлер
sri	шри
donoghue	донохью
riise	риисе
macapagal	макапагал
brabham	брэбэм
bronfenbrenner	бронфенбреннер
englund	энглунд
repo	репо
paasio	паасио
hammarskjöld	хаммаршёльд
saldana	салдана
agosti	агости
kazushi	кадзуси
kostadinov	костадинов
agosto	агосто
eschenbach	эшенбах
renaudot	ренодо
parisot	паризо
festing	фестинг
edlund	эдлунд
grumiaux	грюмьо
amoruso	аморузо
lian	лянь
borromeo	борромео
korhonen	корхонен
bara	бара
micheline	мишлин
shamsuddin	шамсуддин
alam	алам
krsto	крсто
cuming	каминг
shams	шамс
schwabe	швабе
milliken	милликен
langevin	ланжевен
strecker	штрекер
michálek	михалек
kanda	канда
büri	бури
dolby	долби
mollier	молье
limo	лимо
schirmer	ширмер
tank	танк
classen	классен
bard	бард
filangieri	филанджиери
tanguy	танги
tulsi	тулси
ichimura	итимура
revere	ревир
hecking	хеккинг
henriksson	хенрикссон
iakovos	яковос
ayhan	айхан
carlberg	карлберг
takuma	такума
miljković	милькович
bingbing	бинбин
metsu	метсю
horii	хории
songling	сунлин
qianzhi	цяньчжи
riszdorfer	ришдорфер
gut	гут
bezic	безик
ménard	менар
afanasyev	афанасьев
kammerer	каммерер
kirvesniemi	кирвесниеми
dossena	доссена
doolittle	дулиттл
kirch	кирх
rossolimo	россолимо
schikaneder	шиканедер
elert	элерт
jos	йос
pressly	прессли
gainey	гейни
waldo	вальдо
irenaeus	ириней
seyni	сейни
lam	лам
uesugi	уэсуги
belfort	белфорт
armfelt	армфельт
coetzee	кутзее
plíšková	плишкова
siraj	сирадж
alexandrine	александрина
annan	аннан
afranius	афраний
budd	бадд
bebel	бебель
colfer	колфер
balodis	балодис
mayr	майр
ondříček	ондржичек
peel	пил
suchý	сухи
blondin	блонден
sobotka	соботка
newby	ньюби
pirkko	пиркко
israëls	исраэлс
lansbury	лэнсбери
ingeborg	ингеборг
victorino	викторино
damiani	дамиани
redding	реддинг
murkowski	меркауски
russ	русс
hanni	ханни
pero	перо
cripps	криппс
hoag	хоаг
yasumasa	ясумаса
berkowitz	берковиц
petteri	петтери
fukushima	фукусима
guitry	гитри
maé	маэ
matheus	матеус
bautista	баутиста
busey	бьюзи
lefébure	лефебюр
hartshorne	хартшорн
cromwell	кромвель
tosh	тош
galbaio	гальбао
amiri	амири
elemér	элемер
riquelme	рикельме
ghattas	гаттас
uche	уче
balsamo	бальзамо
zec	зец
klemetsen	клеметсен
needham	нидхэм
bassett	бассетт
takakura	такакура
britta	бритта
cantrell	кантрелл
admir	адмир
sirmais	сирмайс
ōtsuka	оцука
costante	костанте
amft	амфт
caligula	калигула
juuso	юусо
mulgrew	малгрю
pinsent	пинсент
stenbäck	стенбек
kindelán	кинделан
cudicini	кудичини
cologna	колонья
nowowiejski	нововейский
corina	корина
minić	минич
jiao	цзяо
diaby	диаби
chantelle	шантель
brand	брэнд
trindade	триндаде
hauswald	хаусвальд
galliano	гальяно
xhaka	джака
dieudonné	дьёдонне
syers	сайерс
sallustius	саллюстий
seius	сей
michaeli	михаэли
walser	вальзер
schlosser	шлоссер
alena	алена
fick	фик
wrede	вреде
phyllida	филлида
löhr	лёр
thomason	томасон
serre	серр
heras	эрас
gaudin	годен
beran	беран
morishima	морисима
villarreal	вильярреаль
rashidi	рашиди
seeberg	зееберг
bongartz	бонгарц
séguier	сегье
ferlin	ферлин
gennaro	дженнаро
sota	сота
waring	уоринг
bialik	бялик
jozić	йозич
talvela	талвела
grünfeld	грюнфельд
rycroft	райкрофт
bibb	бибб
kashgari	кашгари
stoch	стох
warnock	уорнок
barend	баренд
sillanpää	силланпяя
ninis	нинис
sotiris	сотирис
wolde	волде
elkan	элькан
grümmer	грюммер
brahms	брамс
adamou	адаму
harwood	харвуд
wozniak	возняк
chalkokondyles	халкокондил
lipponen	липпонен
nwankwo	нванкво
stover	стовер
naumburg	наумбург
jenn	дженн
topi	топи
sobieski	собеский
taksin	таксин
burkhard	буркхард
dixie	дикси
yeom	ём
ōhira	охира
lotz	лотц
oskars	оскарс
lutosławski	лютославский
helgesson	хельгессон
virgilijus	виргилиюс
mcenroe	макинрой
gongsun	гунсунь
vannutelli	ваннутелли
krabbé	краббе
diller	диллер
kretschmann	кречманн
flagg	флэгг
albini	альбини
afzelius	афцелиус
bhāskara	бхаскара
eisenhower	эйзенхауэр
plüschow	плюшов
tamir	тамир
godse	годзе
rathbone	рэтбоун
alexandrescu	александреску
évora	эвора
manninen	маннинен
espín	эспин
sadao	садао
lachenal	лашеналь
brayden	брэйден
flett	флетт
kitamura	китамура
gestido	хестидо
amer	амер
moumouni	мумуни
tho	тхо
sipilä	сипиля
zdeno	здено
mader	мадер
meng	мэн
firth	фёрт
lantos	лантос
mba	мба
messier	мессье
masahisa	масахиса
vijay	виджай
nyers	ньерш
suhrawardy	сухраварди
mamie	мейми
rühle	рюле
senghor	сенгор
gisco	гиско
bordes	борд
scotto	скотто
carné	карне
phuc	фук
bissett	биссетт
ori	ори
vranješ	враньеш
mix	микс
rómmel	руммель
elfman	эльфман
basta	баста
esprit	эспри
burdenski	бурденски
passer	пассер
lachlan	лаклан
getz	гетц
ornelas	орнелас
hauer	хауэр
boulle	буль
petrescu	петреску
diener	динер
schindler	шиндлер
agardh	агард
ishi	иши
mizzi	мицци
kranz	кранц
vespucci	веспуччи
gellius	геллий
antero	антеро
cheli	кели
portman	портман
mcdowell	макдауэлл
scheckter	шектер
montel	монтель
tsuyoshi	цуёси
strămăturaru	стрэмэтурару
figueras	фигерас
kisho	кисё
benvenuti	бенвенути
mousavi	мусави
leary	лири
kraepelin	крепелин
szenes	сенеш
krishnan	кришнан
marshal	маршал
badu	баду
valbusa	вальбуза
proulx	пру
perica	перица
pokorny	покорный
elgin	элджин
katsuki	кацуки
erdoğan	эрдоган
yigal	игаль
smiljanić	смилянич
carême	карем
bataille	батай
burnham	бёрнхем
sakya	сакья
kuchařová	кухаржова
leweck	левек
pandita	пандита
mitsuo	мицуо
ledley	ледли
folcker	фолкер
elhanan	элханан
hoy	хой
emilian	эмилиан
davenant	давенант
stam	стам
garat	гара
townes	таунс
yasuoka	ясуока
lipton	липтон
iwata	ивата
westley	уэстли
vesaas	весос
marouane	маруан
isamu	исаму
sarr	сарр
käthe	кете
lawler	лоулер
jüttner	юттнер
mikkelsplass	миккельспласс
kingdom	кингдом
eldad	эльдад
abbatucci	аббатуччи
schacht	шахт
mayu	маю
neurath	нейрат
barak	барак
aristide	аристид
sharbini	шарбини
hakob	акоп
basiliscus	василиск
huzziya	хуцция
símun	симун
abrams	абрамс
paletta	палетта
vučković	вучкович
erçetin	эрчетин
jocelyn	жослен
vonnegut	воннегут
frashëri	фрашери
hatem	хатем
bisset	биссет
memphis	мемфис
gide	жид
reck	рек
ayaka	аяка
kęstutaitis	кейстутович
dabija	дабижа
anguissola	ангиссола
knopfler	нопфлер
milenko	миленко
alighiero	алигьеро
dousmanis	дусманис
elise	элиз
genda	гэнда
sofoklis	софоклис
cobo	кобо
kohlberg	кольберг
hielscher	хильшер
aritomo	аритомо
cardona	кардона
holz	хольц
yamagata	ямагата
knopper	кноппер
bajza	байза
mansart	мансар
hardouin	ардуэн
avshalomov	авшаломов
smylie	смайли
zumárraga	сумаррага
wysocki	высоцкий
cattani	каттани
skip	скип
kinnear	киннир
shinawatra	чиннават
athenodoros	афинодор
suhren	зурен
dietz	диц
ueno	уэно
sheamus	шимус
ferrata	феррата
mahamat	махамат
hilario	иларио
schultes	шультес
sheryf	шериф
sigbjørn	сигбьёрн
seabrook	сибрук
boutmy	бутми
ricketts	рикеттс
gillan	гиллан
morozova	морозова
canova	канова
geffen	гефен
dayan	даян
matalon	маталон
fokker	фоккер
strobl	штробль
froriep	фрорип
roper	ропер
tsereteli	церетели
villagra	вильягра
langton	лэнгтон
gasparo	гаспаро
mojmir	моймир
soutter	суттер
dolph	дольф
dionysios	дионисиос
gyllenhaal	джилленхол
tõniste	тынисте
rumiko	румико
korczak	корчак
signori	синьори
zuber	цубер
küçük	кючюк
sunday	сандей
oliseh	олисе
ayọ	эйо
annable	эннэйбл
gabe	гейб
subcomandante	субкоманданте
tera	тера
mazzola	маццола
nicu	нику
matulović	матулович
mubarak	мубарак
tarand	таранд
mišić	мишич
stryjkowski	стрыйковский
hayami	хаями
massalski	масальский
rishi	риши
inese	инесе
vajda	вайда
creighton	крейтон
siudek	сюдек
živojin	живоин
biller	биллер
mirta	мирта
behring	беринг
hattori	хаттори
todt	тодт
chinedu	чинеду
krishan	кришан
wüst	вюст
jamison	джемисон
taryn	тэрин
verbeek	вербек
bigsby	бигсби
reiser	райзер
winstanley	уинстенли
kocher	кохер
idan	идан
hitzfeld	хитцфельд
sintenis	синтенис
frankl	франкл
okoronkwo	окоронкво
fossum	фоссум
mollet	молле
gurney	гёрни
oberländer	оберлендер
gera	гера
bentham	бентам
torun	торун
mitterrand	миттеран
seiling	сейлинг
loredana	лоредана
máximo	максимо
yoram	йорам
kant	кант
balla	балла
mccourt	маккорт
suryavarman	сурьяварман
ehren	эрен
jovana	йована
geoffrion	жеффрион
dragomir	драгомир
delaney	делани
mael	мэйл
baumeister	баумейстер
pandulf	пандульф
binić	бинич
wotherspoon	уотерспун
niculescu	никулеску
jevtić	евтич
zaur	заур
atom	атом
parmentier	пармантье
cervi	черви
shehu	шеху
haushofer	хаусхофер
bertin	бертан
minghella	мингелла
artigas	артигас
pollard	поллард
sessions	сешнс
ramazanov	рамазанов
coste	кост
tanui	тануи
aavik	аавик
chip	чип
schenn	шенн
pêro	перу
niemann	ниман
tigin	тегин
zidi	зиди
niles	найлз
isabelle	изабель
eleftheria	элефтерия
nobuhiko	нобухико
vanhanen	ванханен
moctezuma	монтесума
abdelhamid	абдельхамид
hasdai	хасдай
arnalds	арналдс
nogueira	ногейра
wohlfarth	вольфарт
sammer	заммер
cavagnari	каваньяри
lipmann	липман
roa	роа
florescu	флореску
azari	азари
strachey	стрейчи
hardaway	хардуэй
siddons	сиддонс
chardin	шарден
yinka	йинка
pini	пини
tarmo	тармо
lapidus	лапидус
forqueray	форкре
brecht	брехт
hasson	хасон
kinnunen	киннунен
mola	мола
chaudhry	чоудхури
pippa	пиппа
herodas	герод
kells	келлс
davalos	давалос
seguso	сегусо
peri	пери
kuzmanović	кузманович
olszewski	ольшевский
moriarty	мориарти
horikawa	хорикава
busse	буссе
schild	шильд
dooley	дули
chatterton	чаттертон
kaleta	калета
cesar	сизар
sassoon	сассун
caan	каан
dark	дарк
asmir	асмир
dobbs	доббс
dagnan	даньян
giovinazzo	джовинаццо
yoshitomo	ёситомо
outlaw	аутло
almir	алмир
dannreuther	даннройтер
đura	джура
jakšić	якшич
deodato	деодато
rallis	раллис
cicognani	чиконьяни
furius	фурий
alberts	альбертс
severn	северн
jinnah	джинна
webber	уэббер
łukaszewicz	лукашевич
gagnon	ганьон
fabiana	фабиана
grayson	грейсон
boz	боз
ximena	химена
mallory	мэллори
fabrice	фабрис
escudé	эскюде
biwott	бивотт
cappellini	каппеллини
brodeur	бродёр
wilbur	уилбер
orlev	орлев
rosas	росас
carls	карльс
schwarzenegger	шварценеггер
neff	нефф
landauer	ландауэр
gable	гейбл
mera	мера
heesters	хестерс
hanzō	хандзо
phelan	фелан
brinsley	бринсли
björklund	бьёрклунд
wilkens	уилкенс
minnelli	миннелли
bielecki	белецкий
krajicek	крайчек
tullia	туллия
lazaros	лазарос
nebuchadnezzar	навуходоносор
jaffe	джаффе
arakawa	аракава
almunia	альмуния
golding	голдинг
laskarina	ласкарина
ebba	эбба
joplin	джоплин
calverley	калверли
nilo	нило
servais	серве
giora	гиора
sienna	сиенна
varvodić	варводич
demus	демус
vettius	веттий
juhász	юхас
gaizka	гаиска
akihiko	акихико
benji	бенджи
miyu	мию
hetherington	хетерингтон
q	кью
kallas	каллас
yuji	юдзи
wennerström	веннерстрём
britos	бритос
alamanni	аламанни
stellan	стеллан
gambino	гамбино
cowley	каули
moravec	моравец
oxley	оксли
paolucci	паолуччи
mutch	матч
raya	рая
korjus	корьюс
karan	каран
ebanks	ибэнкс
quimby	куимби
heike	хайке
wahlberg	уолберг
akimov	акимов
cleve	клеве
lochhead	локхед
kiichi	киити
oberstolz	оберштольц
lampkin	лампкин
given	гивен
woodley	вудли
fiorenzo	фьоренцо
mureșan	мурешан
mutu	муту
recoba	рекоба
achleitner	ахляйтнер
tamayo	тамайо
moishe	мойше
túlio	тулио
kavadh	кавад
mizushima	мидзусима
buchwald	бухвальд
jaakson	яаксон
brundle	брандл
isaakovich	исаакович
takhti	тахти
todorova	тодорова
turina	турина
yoshimasa	ёсимаса
wainwright	уэйнрайт
selva	сельва
diallo	диалло
milovanović	милованович
lieber	либер
amis	эмис
schmeisser	шмайссер
simelane	симелане
sohn	зон
testud	тестю
loos	лоос
lewisohn	льюисон
ostrom	остром
paré	паре
naumann	науман
nobuyoshi	нобуёси
houbraken	хоубракен
dudek	дудек
rethel	ретель
waldner	вальднер
kingsbury	кингсбёри
bilić	билич
štěpánek	штепанек
sörvik	сёрвик
binchy	бинчи
gudrun	кримхильда
hitchens	хитченс
bruna	бруна
dalrymple	далримпл
koda	кода
valera	валера
laplace	лаплас
lexi	лекси
vučić	вучич
anže	анже
strasberg	страсберг
żuławski	жулавский
hartnell	хартнелл
glick	глик
brink	бринк
guidi	гвиди
binoche	бинош
bickford	бикфорд
tarnowski	тарновский
herschmann	хершман
reitman	райтман
korać	корач
zellner	целльнер
ugaki	угаки
marcia	марсия
salmi	салми
lorrain	лоррен
bohlin	болин
jørn	йорн
normunds	нормундс
jock	джок
linné	линне
achenbach	ахенбах
curtius	курциус
miltiadis	мильтиадис
boratto	боратто
zabarella	дзабарелла
kovačić	ковачич
lautner	лотнер
pulkkinen	пулккинен
tevfik	тевфик
ferhat	ферхат
jansa	янса
riveros	риверос
dharanindravarman	дхараниндраварман
menges	менгес
aria	ария
ivanišević	иванишевич
bayard	байяр
ellmenreich	эльменрейх
bernadette	бернадетт
babeș	бабеш
oguri	огури
brahim	брахим
franken	франкен
kowalik	ковалик
deakin	дикин
coogan	куган
pastore	пасторе
merriman	мерриман
smirnoff	смирнофф
suchodolski	суходольский
vseslavich	всеславич
bartolović	бартолович
kengo	кэнго
mayor	майор
altıntop	алтынтоп
berto	берто
schopenhauer	шопенгауэр
glodrydd	достопамятный
iban	ибан
shahak	шахак
mantovani	мантовани
cuny	кюни
still	стилл
nylander	нюландер
kuma	кума
fo	фо
márquez	маркес
seretse	серетсе
billingsley	биллингсли
østby	эстбю
valo	вало
stephanopoulos	стефанопулос
lindrum	линдрум
marías	мариас
specter	спектер
güngör	гюнгёр
argyrus	аргир
cabezas	кабесас
pétion	петион
giger	гигер
rosberg	росберг
teng	тенг
halilović	халилович
copley	копли
niculae	никулаэ
escherich	эшерих
kuwashima	кувасима
shushinski	шушинский
beasley	бизли
weidinger	вайдингер
montalvo	монтальво
gerbrand	гербранд
gehlen	гелен
kevork	геворк
stange	штанге
mankiewicz	манкевич
kubík	кубик
laube	лаубе
ilmar	ильмар
mayorga	майорга
wiley	уайли
sprenger	шпренгер
hana	хана
argento	ардженто
kjetil	хьетиль
machida	матида
moncada	монкада
balys	балис
panabaker	панабэйкер
cyngen	кинген
orontes	ерванд
ureña	уренья
koivisto	койвисто
herennius	геренний
colson	колсон
eccleston	экклстон
kazushige	кадзусигэ
montalbán	монтальбан
borut	борут
matjaž	матьяж
mijailović	мияилович
rodan	родан
strittmatter	штриттматтер
hirayama	хираяма
heilmann	хайльман
arévalo	аревало
valerian	валериан
wörner	вёрнер
milhaud	мийо
rino	рино
wester	уэстер
bosco	боско
piccoli	пикколи
pell	пелл
grbić	грбич
gambara	гамбара
florêncio	флоренсио
djemba	джемба
babbage	бэббидж
cozy	кози
rafi	рафи
himmler	гиммлер
bachchan	баччан
paulsen	паульсен
vauquelin	воклен
tassilo	тассило
holtzendorff	хольцендорф
klos	клос
ochiryn	очирын
wölfli	вёльфли
hurwitz	гурвиц
shimamoto	симамото
peiyuan	пэйюань
arena	арена
witkin	уиткин
trond	тронн
erben	эрбен
rinus	ринус
herodian	геродиан
volkan	волкан
lochner	лохнер
joshi	джоши
schlemmer	шлеммер
hirschfeld	хиршфельд
kokko	кокко
czerny	черни
szymanowski	шимановский
pound	паунд
carrasco	карраско
badran	бадран
yupanqui	юпанки
dönitz	дёниц
applegate	эпплгейт
sada	сада
tomizawa	томидзава
capperonnier	капперонье
avni	авни
väyrynen	вяюрюнен
lucarelli	лукарелли
buttigieg	буттиджич
nepherites	неферит
corliss	корлисс
sundin	сундин
sveinbjörn	свейнбьёрн
venizelos	венизелос
pepper	пеппер
jump	джамп
chisholm	чисхолм
květa	квета
beckham	бекхэм
anselmo	ансельмо
joely	джоэли
mercator	меркатор
shevket	шевкет
doesburg	дусбург
willemse	уиллемс
moyer	мойер
anish	аниш
awad	авад
savisaar	сависаар
cudmore	кадмор
gerritsz	герритс
mcclendon	макклендон
lafitte	лафит
abboud	аббуд
bernays	бернайс
didius	дидий
jerichau	йерихау
castel	кастель
nesta	неста
clovis	хлодвиг
tsui	цуй
buckland	баклэнд
broda	брода
eng	энг
ogawa	огава
bracquemond	бракемон
puenzo	пуэнсо
berruguete	берругете
bergkamp	бергкамп
hoa	хоа
lac	лак
panah	панах
legouvé	легуве
acklin	аклин
bette	бетт
mullins	маллинз
seidel	зайдель
conroy	конрой
rilke	рильке
creswick	кресвик
cambyses	камбис
stocker	штокер
loriod	лорио
primus	праймус
medford	медфорд
sardou	сарду
chauvin	шовен
melzer	мельцер
appiah	аппиа
keyes	киз
burr	бёрр
zetterberg	зеттерберг
venturi	вентури
tănase	тэнасе
lemieux	лемье
mortara	мортара
nieto	ньето
lovro	ловро
farkas	фаркаш
kasahara	касахара
ketchum	кетчум
edgaras	эдгарас
copeland	коупленд
sumitomo	сумитомо
reimer	раймер
fabrizi	фабрици
luděk	людек
naismith	нейсмит
nomi	номи
lundquist	лундквист
izetbegović	изетбегович
kinoshita	киносита
nagano	нагано
boozer	бузер
bryson	брайсон
takelot	такелот
andújar	андухар
honegger	хонеггер
winwood	уинвуд
hiroko	хироко
athena	афена
simeoni	симеони
hongbo	хунбо
polydore	полидор
carrier	каррье
schulhoff	шульгоф
sordi	сорди
hartmanis	хартманис
mcdonough	макдоно
hämäläinen	хямяляйнен
tetmajer	тетмайер
schrott	шротт
andreasen	андреасен
ipato	ипато
samira	самира
winge	винге
grundig	грундиг
camarasa	камараса
herluf	херлуф
alemán	алеман
shirin	ширин
ulvaeus	ульвеус
sanger	сэнгер
michell	мичелл
sigismondo	сиджизмондо
cremona	кремона
tolkien	толкин
powe	поу
vane	вейн
marquette	маркетт
dent	дент
weis	уэйс
hesselink	хесселинк
ag	аг
arjun	арджун
seti	сети
delphine	дельфина
hamerik	хамерик
barnard	барнард
saigō	сайго
kozuka	кодзука
attanasio	аттанасио
mungo	мунго
jalabert	жалабер
robins	робинс
papazoglou	папазоглу
biden	байден
lippmann	липпман
dryden	драйден
heaney	хини
rigobert	ригобер
biao	бяо
rau	рау
goch	гох
dalia	далия
kieran	киран
antal	антал
top	топ
obolensky	оболенский
besnard	бенар
cheyrou	шейру
kaido	кайдо
casado	касадо
caminha	каминья
ouyang	оуян
maxi	макси
bosmans	босманс
sarti	сарти
merikanto	мериканто
benzoni	бенцони
unai	унай
wasson	уоссон
valentim	валентим
east	ист
tavernier	тавернье
gioachino	джоакино
tulasne	тюлан
strack	штрак
luong	лыонг
schiffer	шиффер
spahić	спахич
fenech	фенек
quicherat	кишра
bova	бова
teri	тери
bogosian	богосян
johar	джохар
vibeke	вибеке
asle	асле
hege	хеге
lapid	лапид
gorman	горман
tatham	тэтхем
hedrick	хедрик
jagger	джаггер
wilf	уилф
werle	верле
sîrbu	сырбу
heaton	хитон
hefti	хефти
heikkinen	хейккинен
fromm	фромм
silvino	силвину
kashiwabara	касивабара
silverthorne	сильверторн
björkman	бьоркман
roslin	рослин
klemperer	клемперер
andi	анди
vatroslav	ватрослав
manigat	манига
hadler	хадлер
enke	энке
demirel	демирель
husky	хаски
obiang	обианг
asensi	асенси
bayle	бейль
tonči	тончи
nwoko	нвоко
gabrić	габрич
klimavičius	климавичюс
sandahl	сандаль
maldini	мальдини
cranston	кренстон
đukić	джукич
fons	фонс
rosato	розато
rozhdestvensky	рождественский
cordeiro	кордейру
schiegl	шигль
spano	спано
rugendas	ругендас
huub	хуб
leino	лейно
thalía	талия
sohrab	сохраб
paillot	пайо
rott	ротт
kuribayashi	курибаяси
ivanovski	ивановский
hajós	хайош
želimir	желимир
geefs	гефс
lemmon	леммон
tarnawsky	тарнавский
calloway	кэллоуэй
nevin	невин
niven	нивен
lobsang	лобсанг
belladonna	белладонна
solange	соланж
siorpaes	сьорпаэс
zion	цион
adeang	аданг
vlade	владе
faà	фаа
szilárd	силард
albéniz	альбенис
krahelska	крахельская
forlani	форлани
dworkin	дворкин
lahiri	лахири
kisfaludy	кишфалуди
abegg	абегг
munson	мансон
sláma	слама
bromfield	бромфилд
figes	файджес
schlüter	шлютер
buljat	булят
etchegaray	эчегерай
záhlavová	заглавова
amat	амат
boniek	бонек
barrington	баррингтон
ek	эк
gracias	грасиас
scheidt	шейдт
shiba	сиба
gratton	грэттон
danica	даника
aelius	элий
kashtan	каштан
joly	жоли
rahl	раль
eadred	эдред
checa	чека
mort	морт
mckellar	маккеллар
kinkel	кинкель
plummer	пламмер
toini	тойни
gramatté	граматте
kristaps	кристап
morone	мороне
cobden	кобден
henriksen	хенриксен
shimomura	симомура
cavani	кавани
haven	хэвен
peccei	печчеи
schmelzer	шмельцер
onda	онда
malipiero	малипьеро
pine	пайн
pitkänen	питкянен
grahn	гран
guyot	гюйо
dani	дани
korpi	корпи
lupe	лупе
krohn	крон
zelaya	селайя
carrizo	каррисо
fazekas	фазекаш
mantle	мэнтл
brauner	браунер
affleck	аффлек
huysmans	гюисманс
oikawa	оикава
delio	делио
barnabas	варнава
pešek	пешек
legendre	лежандр
méliès	мельес
kronecker	кронекер
agnolo	аньоло
tange	тангэ
bree	бри
trotter	троттер
bhattarai	бхаттараи
konstantinidis	константинидис
olita	олита
junzo	дзюндзо
topić	топич
piron	пирон
heiden	хайден
seghers	зегерс
panos	панос
naji	наджи
idahor	идахор
filippos	филиппос
bhatti	бхатти
takemura	такэмура
hidalgo	идальго
blanford	бланфорд
donoso	доносо
kučová	кучова
biljana	биляна
ersoy	эрсой
velázquez	веласкес
kaneda	канэда
spelling	спеллинг
mulholland	малхолланд
rosalind	розалинд
tomoaki	томоаки
pasini	пазини
ilievski	илиевски
bonatti	бонатти
weston	уэстон
claver	клавер
schafer	шейфер
pichon	пишон
alcott	олкотт
mečislovas	мечисловас
szondi	сонди
dance	дэнс
dury	дьюри
christoffel	кристоффель
jeppe	йеппе
anda	анда
huyghe	юиг
mui	муи
montefiore	монтефиоре
broz	броз
hepworth	хепуорт
sema	сэма
brugger	бруггер
alonzo	алонзо
hefner	хефнер
herbie	херби
vokes	воукс
tero	теро
edme	эдм
valon	валон
labienus	лабиен
biržiška	биржишка
bocanegra	боканегра
kalpana	калпана
lachmann	лахманн
verdú	верду
silk	силк
sanjō	сандзё
géraud	жеро
sangster	сангстер
itagaki	итагаки
romina	ромина
matty	мэтти
yoshiyuki	ёсиюки
ancillon	ансильон
buchholz	бухгольц
żeromski	жеромский
mat	мэт
vierny	верни
goffredo	гоффредо
dery	дери
canisius	канизий
friedl	фридль
rosario	розарио
tazio	тацио
joaquim	жоаким
panić	панич
pertwee	пертви
svetislav	светислав
helguera	эльгера
bøkko	бёкко
orellana	орельяна
meloni	мелони
llosa	льоса
bateson	бейтсон
capello	капелло
ahonen	ахонен
schaub	шауб
dassault	дассо
eliška	элишка
kowal	коваль
laporte	лапорте
myhre	мюре
marcella	марчелла
tugay	тугай
helgi	хельги
mesić	месич
etta	этта
ólafsson	олафссон
victorine	викторина
kawamura	кавамура
ōkawa	окава
corso	корсо
kunze	кунце
leung	люн
kühne	кюне
ok	ок
micara	микара
ruthardt	рутхардт
ogier	ожье
fair	фэйр
erdal	эрдал
gentileschi	джентилески
adrianne	эдрианн
mothe	мот
ainsworth	эйнсворт
merrifield	меррифилд
mulligan	маллиган
giustiniani	джустиниани
novica	новица
jolie	джоли
leclair	леклер
kazimieras	казимерас
ekmanis	экманис
johnathon	джонатон
machiko	матико
mikkelsen	миккельсен
simoni	симони
kylie	кайли
małachowski	малаховский
vink	винк
montejo	монтехо
navrátil	навратил
nevio	невио
němec	немец
rosso	россо
schartau	шартау
stillman	стиллман
johner	ионер
næss	нэсс
kushida	кусида
sneijder	снейдер
sandberg	сандберг
kanter	кантер
heer	хеер
janine	джанин
manzoni	мандзони
eckersberg	эккерсберг
hiatt	хайатт
champion	шампьон
vipsania	випсания
cabeza	кабеса
theudebert	теодеберт
sembratovych	сембратович
seaman	симен
candela	кандела
bourchier	буршье
hatun	хатун
chmielowski	хмелёвский
dudás	дудаш
fehn	фен
anaya	анайя
kuske	куске
juantorena	хуанторена
foote	фут
marjanović	марьянович
ewelina	эвелина
solberg	сольберг
airy	эйри
tadese	тадесе
machulski	махульский
ateas	атей
koeman	куман
date	датэ
cheney	чейни
dalí	дали
bronius	бронюс
allofs	аллофс
zhuk	жук
hennessy	хеннесси
brom	бром
postel	постель
briana	бриана
kuckhoff	кукхоф
maquet	маке
jakubowska	якубовская
mew	мью
baldi	бальди
bosschaert	босхарт
varis	варис
belcher	белчер
bianchini	бьянкини
urho	урхо
barna	барна
helle	хелле
beecher	бичер
prisco	приско
hausen	хаузен
imhoff	имхофф
jürgens	юргенс
pausin	паузин
morihiro	морихиро
rivadavia	ривадавия
massaro	массаро
brenden	бренден
nagata	нагата
suazo	суасо
fiore	фьоре
besson	бессон
spriggs	сприггс
licia	личия
arrowsmith	арроусмит
hochschorner	гохшорнер
risa	риса
madariaga	мадарьяга
featherstone	физерстоун
kazue	кадзуэ
yoshie	ёсиэ
loeb	лёб
leonte	леонте
heisuke	хэйсукэ
gad	гад
abramson	абрамсон
blomqvist	блумквист
arrighi	арриги
skujenieks	скуениекс
dano	дано
priddy	придди
calais	кале
feltscher	фельтшер
eisler	айслер
quigley	куигли
yehoshua	иегошуа
kurita	курита
wing	винг
mulla	мулла
eisenberg	айзенберг
gundars	гундарс
takako	такако
trude	труде
erminio	эрминио
dinara	динара
elvir	элвир
fortis	фортис
mantas	мантас
sakuma	сакума
alberico	альберико
duong	зыонг
kuffour	куффур
ammi	амми
upshaw	апшоу
petrovický	петровицки
braverman	браверман
kakuta	какута
simeone	симеоне
cuoco	куоко
nussbaum	нуссбаум
spiegelman	шпигельман
elek	элек
overbeck	овербек
astin	астин
baddeley	баддели
hamlin	хэмлин
bott	ботт
maktoum	мактум
ciobanu	чобану
streit	штрайт
sanda	санда
babe	бейб
farro	фарро
mehring	меринг
labouré	лабуре
rosalia	розалия
malkiel	малкиэль
suppiluliuma	суппилулиума
bessette	бессетт
stadlober	штадлобер
uhde	уде
ørsted	эрстед
šulek	шулек
kirovski	кировский
whittindale	уиттиндейл
oliphant	олифант
carnes	карнс
laub	лауб
turgut	тургут
hilliard	хиллиард
korman	корман
mangiarotti	манджаротти
emmons	эммонс
mcgowan	макгоуэн
perišić	перишич
gevaert	геварт
vigneault	виньо
bergeron	бержерон
hidaka	хидака
bernarda	бернарда
miķelis	микелис
balázs	балаж
baz	баз
maura	маура
belle	белль
lundgren	лундгрен
nikisch	никиш
baby	бэби
emden	эмден
hayao	хаяо
blunstone	бланстоун
georgescu	джорджеску
bonner	боннер
valters	валтерс
vignoles	виньоль
delanoë	деланоэ
grass	грасс
bitter	биттер
amélie	амели
vedder	веддер
vučević	вучевич
aviv	авив
ndong	ндонг
cecily	сесили
malberg	мальберг
sarandon	сарандон
luo	ло
hand	хэнд
živojinović	живоинович
parton	партон
mcavoy	макэвой
arenas	аренас
varazdat	вараздат
ihne	ине
coypel	куапель
pickering	пикеринг
vitorino	виторину
cornel	корнел
antunes	антунеш
vespasiano	веспасиано
karanović	каранович
bembo	бембо
dibaba	дибаба
kowalski	ковальский
bellincioni	беллинчони
morón	морон
poincaré	пуанкаре
caffarelli	каффарелли
kasdan	кэздан
gartner	гартнер
izoria	изория
dinicu	динику
moyse	моиз
zhiyuan	чжиюань
zhenyu	чжэньюй
boston	бостон
onesiphorus	онисифор
owusu	овусу
scheibe	шайбе
nasri	насри
antonini	антонини
dorset	дорсет
hatoyama	хатояма
thurman	турман
fumiko	фумико
orikasa	орикаса
mctell	мактелл
castellazzi	кастеллацци
ilmārs	илмар
harrelson	харрельсон
sorvino	сорвино
pelli	пелли
nader	надер
tian	тянь
cuvillier	кювилье
mitar	митар
rodolphe	родольф
duguay	дюгей
giri	гири
bouts	баутс
bobrowski	бобровский
hatano	хатано
prica	прица
schönfeld	шёнфельд
sandén	санден
debi	деби
eisenstadt	эйзенштадт
obrecht	обрехт
carmassi	кармасси
wallerius	валлериус
leskinen	лескинен
amara	амара
lucca	лукка
wankel	ванкель
kapodistrias	каподистрия
melitta	мелитта
irigoyen	иригойен
kroos	кроос
bilodeau	билодо
birkin	биркин
akimoto	акимото
kaurismäki	каурисмяки
bamba	бамба
swart	сварт
håkansson	хоканссон
weld	уэлд
hostilius	гостилий
vicent	висент
lebensohn	лебенсон
martinet	мартине
close	клоуз
allegri	аллегри
manor	манор
tolga	толга
nishio	нисио
yardley	ярдли
groves	гровс
manea	маня
eckstein	экштайн
stiles	стайлз
sandino	сандино
mitić	митич
katzer	катцер
ignatius	игнатий
jarmila	ярмила
lal	лал
demba	демба
rehn	рен
hawkes	хоукс
ypsilantis	ипсиланти
allais	алле
rebel	ребель
fabien	фабьен
garrel	гаррель
merlin	мерлин
derk	дерк
cannavaro	каннаваро
ende	энде
handanović	ханданович
elson	элсон
drost	дрост
stickney	стикни
maddox	мэддокс
pilette	пилетт
teodorov	теодоров
madou	маду
graafland	графланд
yefimovich	ефимович
mirja	мирья
kokoszka	кокошка
dass	дасс
cassavetes	кассаветис
patry	патри
cheruiyot	черуйот
casal	касаль
keisuke	кэйсукэ
bianconi	бьянкони
shizuka	сидзука
chawla	чавла
hornung	хорнунг
bartholomeus	бартоломеус
lauda	лауда
monnet	монне
agim	агим
seydou	сейду
nolasco	ноласко
lini	лини
sandrelli	сандрелли
brooklyn	бруклин
lübke	любке
byung	бён
mcardle	макардл
haugli	хёугли
rudisha	рудиша
bobach	бобах
ferenczy	ференци
vegard	вегард
miyoshi	миёси
mcneil	макнил
phaneuf	фанёф
viorica	виорика
spall	сполл
cossa	косса
ravi	рави
korbinian	корбиниан
sturridge	старридж
nat	нэт
péguy	пеги
yoshihara	ёсихара
brož	брож
adamo	адамо
adrianna	адрианна
runciman	ренсимен
istad	истад
kostelić	костелич
scaliger	скалигер
kondō	кондо
mpenza	мпенза
breslin	бреслин
nakasone	накасонэ
sarafian	сарафян
sokolović	соколович
trübner	трюбнер
shifu	шифу
gallatin	галлатин
pace	пэйс
harting	хартинг
duan	дуань
asturias	астуриас
machuca	мачука
guccione	гуччионе
klee	клее
collier	кольер
berke	берке
vander	вандер
hyakutake	хякутакэ
merian	мериан
galilei	галилей
eija	эйя
ratzenhofer	ратценхофер
charron	шаррон
septimius	септимий
rota	рота
kisch	киш
mcdevitt	макдевит
jordin	джордин
farías	фариас
hirofumi	хирофуми
schulte	шульте
dharma	дхарма
buxbaum	буксбаум
pellegrino	пеллегрино
arabi	араби
waldeck	вальдек
manilius	манилий
menu	меню
gainsbourg	генсбур
amílcar	амилкар
ordóñez	ордоньес
sobieska	собеская
godfried	годфрид
lorena	лорена
fortunatus	фортунат
griesbach	грисбах
khairallah	хейраллах
gretchen	гретхен
nilson	нильсон
haider	хайдер
hampshire	хэмпшир
card	кард
denner	деннер
stacey	стейси
miyagi	мияги
treat	трит
lurz	лурц
stelios	стелиос
souvestre	сувестр
thorburn	торбурн
verlaine	верлен
kapanen	капанен
reto	рето
carmel	кармел
reston	рестон
flannery	флэннери
mcmaster	макмастер
yuanji	юаньцзи
alistair	алистер
tuxen	туксен
portuondo	портуондо
avogadro	авогадро
horrebow	хорребоу
lakis	лакис
dassin	дассен
sara	сара
david	давид
vladislav	владислав
bryan	брайан
lukas	лукас
susan	сьюзен
barry	бэрри
roland	ролан
toni	тони
ronald	роналд
eddy	эдди
erica	эрика
schwartz	шварц
bruno	брюно
reiner	райнер
marián	мариан
stanislav	станислав
ralf	ральф
natan	натан
marko	марко
kris	крис
cameron	камерон
geoff	джефф
raphael	рафаэль
ricardo	рикарду
li	ли
günter	гюнтер
albert	альбер
angela	ангела
jimmie	джимми
harry	харри
dickson	диксон
peterson	питерсон
leo	лев
lynda	линда
noah	ной
bohdan	богдан
costas	костас
taylor	тэйлор
niels	нильс
adrian	эдриан
alois	алоиз
herbert	херберт
mattias	маттиас
claus	клаус
pal	пал
nilsen	нильсен
aloys	алоис
frank	франк
jonny	джонни
rok	рок
georgios	йоргос
klein	кляйн
lili	лили
johnstone	джонстон
betti	бетти
christen	кристен
long	лун
back	бак
dwayne	дуэйн
root	рут
blake	блэйк
giorgio	джорджио
yvonne	ивонна
oswaldo	освальдо
christian	христиан
eva	эва
stjepan	степан
lidia	лидия
mills	миллз
rodgers	роджерс
graham	грэхэм
gerry	джерри
henrique	энрике
robert	робер
rachael	рэйчел
andres	андрес
walerian	валериан
grégory	грегори
cooke	кук
aksel	аксель
herman	герман
kirk	кёрк
andries	андрис
paulo	паулу
bahr	бар
roy	руа
gastón	гастон
harold	харольд
ilia	илья
busch	буш
austen	остин
norah	нора
macgregor	макгрегор
vadym	вадим
tim	тимоти
florence	флоранс
elías	элиас
kit	кит
magnus	магн
keith	кейт
schaefer	шефер
ibrahim	ибрахим
judith	юдит
goldberg	гольдберг
billie	билли
garry	гарри
frances	фрэнсис
martin	мартен
martín	мартин
ricky	рикки
kōichi	коити
blair	блэйр
osvaldo	освалдо
evelyn	ивлин
jérémie	жереми
atkins	эткинс
yūki	юки
pratt	прэтт
bassus	басс
larry	лэрри
alfredo	алфредо
dru	дрю
yūji	юдзи
dinah	дина
micky	мики
nik	ник
leitner	ляйтнер
myriam	мириам
robby	робби
caplan	каплан
fabris	фабрис
benny	бени
brook	брук
glória	глория
dennis	дэннис
miriam	мирьям
édith	эдит
anatol	анатоль
nicholls	николс
byrne	берн
geraldine	джеральдина
duvall	дюваль
baumann	бауманн
amos	эймос
maris	марис
geert	герт
ferri	ферри
ola	ула
gabor	габор
keiko	кейко
iván	иван
ole	уле
thorsten	торстен
steel	стил
daniela	даниела
bianchi	бианки
artur	артур
abel	абел
leyla	лейла
rafael	рафаэл
jo	джо
lesley	лесли
yaqub	якуб
michelle	мишель
richard	рихард
luka	лука
emmanuelle	эммануэль
lambert	ламбер
bertie	берти
aristides	аристид
mordecai	мордехай
johansson	йоханссон
cain	кейн
maury	мори
igor	игор
michael	михаэль
dave	дейв
walker	уолкер
isaac	айзек
branco	бранко
markovich	маркович
jiří	йиржи
jeanne	джинн
lorenzo	лоренсо
robyn	робин
gyula	дюла
věra	вера
guido	гуидо
loren	лорен
lászló	надь
sam	сам
joanne	джоан
ihor	игорь
oleh	олег
john	иоанн
elena	элена
hertz	герц
turner	тернер
sebastian	себастиан
lucian	лукиан
maurício	маурисио
carlyle	карлайл
kelley	келли
shahin	шахин
rudolph	рудольф
alice	алиса
fernando	фернанду
carel	карел
marion	мэрион
irene	ирина
gottlieb	готтлиб
josé	жозе
martí	марти
miles	майлс
cristian	кристиан
gennadi	геннадий
arnold	арнолд
ervin	эрвин
rodrigues	родригес
patrik	патрик
ted	тэд
joan	жоан
ignatius	игнатиус
epstein	эпстайн
marius	марий
leroy	леруа
adrián	адриан
kaj	кай
rockwell	роквелл
mason	мэйсон
barbara	варвара
thon	тон
fanni	фанни
simons	саймонс
martins	мартинш
nathan	нейтан
sima	сима
alek	алек
anastasiya	анастасия
christophe	кристоф
semen	семён
wacław	вацлав
duncan	данкан
anthony	антони
elis	элис
byrd	бёрд
lehmann	леманн
e	эдвард
fernand	фернанд
maja	майя
wolf	вульф
bernhard	бернгард
alexander	александер
arthur	артюр
teena	тина
jackie	джекки
grace	грэйс
arne	арн
wallis	уэллис
petrosian	петросян
sand	занд
efraim	эфраим
yaroslav	ярослав
sang	сан
cao	као
reggie	регги
humperdinck	энгельберт
né	не
jenő	йенё
kempe	кемп
dolley	долли
jannik	янник
patricia	патрисия
piper	пипер
duran	дюран
manly	мэнли
har	гуру
vidal	видал
deniz	дениз
christy	кристи
ramon	рамон
goodman	гудман
angelo	анжело
septimius	север
boutros	гали
ghali	бутрос
severus	септимий
martinez	мартинес
hana	гана
yelena	елена
gallacher	галлахер
carole	кэрол
zeller	зеллер
grossmann	гроссман
kehr	кер
jeanette	джанет
goswami	кришна
christensen	ларс
eugenio	эухенио
thea	тея
macbride	макбрайд
olsson	олссон
mackey	маккей
nate	нэйт
deborah	девора
mcdowall	макдауэлл
weston	вестон
yorke	йорк
luv	лав
mindaugas	миндовг
kiran	киран
filipowicz	филипович
lentz	ленц
ailyn	айлин
perl	перл
débora	дебора
dimitar	димитров
sávio	савио
meadows	мидоус
jennifer	хейл
lilyan	лилиан
yuko	юко
urszula	урсула
greg	грэг
polley	полли
blanchard	блэнчард
piá	пиа
huet	юэ
wahid	вахид
idriss	идрис
wylie	уайли
vytautas	витовт
schroeter	шрётер
ivars	ивар
arielle	ариэль
bear	бир
kondo	кондо
welch	уэлш
celsus	цельз
bo	бу
arpad	арпад
tobey	тоби
ireland	айрлэнд
maya	мая
bloom	блюм
eliyahu	элисар
caranus	каран
feldmann	фельдман
rahm	рам
seth	сиф
ghandy	ганди
tomo	томислав
nemec	немец
mancini	мансини
wade	вейд
gregoire	грегуар
petković	душан
maximiliano	максимильяно
elijah	илия
erni	эрни
florianus	флориан
newman	ньюмен
niemi	антти
antti	ниеми
moss	мхи
berthold	бертхольд
desmond	дезмонд
jonah	джона
slater	слейтер
dorothée	дороти
milos	милош
gerardo	джерардо
brie	бри
schulman	шульман
lestek	лешек
čech	марек
bela	бела
pehrsson	перссон
gediminas	гедимин
nachum	нахум
wille	вилле
alyson	элисон
winckler	винклер
dag	даг
boch	бош
roméo	ромео
danny	данни
koné	бакари
rutherfurd	резерфорд
corda	корда
ricki	рики
berger	берже
columbus	колумб
joey	джои
luciano	лусиано
myles	майлз
giambattista	джамбатиста
mourad	мурад
asheton	эштон
lyall	лайл
valdemar	вальдемар
antal	анталь
blum	блум
dio	дион
rosario	росарио
winston	винстон
petras	петрас
denny	дэнни
cavanagh	кавана
baker	бэйкер
frieda	фрида
conny	конни
aharon	аарон
steffen	стеффен
bernstein	бернстайн
benoit	бенуа
kostić	бора
harrison	гаррисон
beverley	беверли
fraser	фрэйзер
zoltán	варга
jayne	джейн
tie	те
marcel	марцель
hopkins	гопкинс
landes	лэндис
hynes	хайнс
rohmer	ромер
ferenc	деак
petrie	петри
amédée	амеде
else	эльза
shue	шу
longus	лонг
lennie	ленни
reginald	реджиналд
téa	теа
lake	лэйк
nikolaos	никос
lindbergh	линдберг
lehtonen	микко
mikko	лехтонен
suzuki	тосио
toshio	судзуки
caron	кэрон
mélanie	мелани
sandie	сэнди
will	вилл
cortez	кортес
russ	расс
mackie	маки
krystal	кристал
szabo	сабо
pavić	милорад
jameel	джамиль
dalton	дальтон
bryant	брайнт
nagy	ласло
kowalski	тадеуш
vargas	льоса
stark	штарк
llosa	варгас
robin	робен
josh	джошуа
bonney	бонни
mollie	молли
nei	ней
milorad	павич
curtis	кертис
soyer	сойер
cecilia	чечилия
balázs	балаш
clovis	кловис
émilie	эмили
yates	йетс
franck	франк
patricia	патриша
alice	алис
richard	ришар
harri	харри
michael	михаил
kelli	келли
igors	игорь
leigh	ли
jarosław	ярослав
antoni	антони
zsa	габор
gabor	жа
patrícia	патрисия
myles	майлс
bu	бу
emilie	эмили
mōri	мори
mordehai	мордехай
cristian	ледесма
marti	марти
joanne	джоанн
li	юй
ewa	эва
sebastianus	себастиан
eugenio	эугенио
